Año,Trimestre,Provincia,HASTA 512 kbps,+ 512 Kbps - 1 Mbps,+ 1 Mbps - 6 Mbps,+ 6 Mbps - 10 Mbps,+ 10 Mbps - 20 Mbps,+ 20 Mbps - 30 Mbps,+ 30 Mbps,Otras Velocidades,Total Velocidades,Mbps (Media de bajada),ADSL,Cablemodem,Fibra óptica,Wireless,Otros,Total Accesos,Banda ancha fija,Dial up,Total dial_BAf,Accesos por cada 100 hogares,Accesos por cada 100 hab
2023,4,Buenos Aires,26909,23962,228393,239339,246144,110876,4042646,93351,5011620,158.49,223391,2797700,1784593,137993,67943,5011620,5005720,5900,5011620,80.96,27.68
2023,4,Capital Federal,516,4544,26409,48083,33925,5829,1355061,0,1474367,234.44,58700,1198835,182520,4492,29820,1474367,1472317,2050,1474367,117.02,47.8
2023,4,Catamarca,71,209,3065,3734,4423,1827,61181,77,74587,89.4,6669,11016,55437,1384,81,74587,74586,1,74587,68.63,17.46
2023,4,Chaco,236,477,14811,10361,6247,5729,105485,4040,147386,107.14,14000,60277,62301,8404,2404,147386,147381,5,147386,44.35,11.85
2023,4,Chubut,111,1088,44276,31402,22843,20196,33665,16589,170170,20.29,26306,77217,26174,30543,9930,170170,169313,857,170170,84.96,26.04
2023,4,Córdoba,99,8404,117068,91169,51126,26948,767427,17061,1079302,114.03,115662,452380,440536,61862,8862,1079302,1079239,63,1079302,90.67,27.76
2023,4,Corrientes,67,2889,19949,17984,8108,5087,98904,6484,159472,100.9,21769,86102,35968,10402,5231,159472,159469,3,159472,52.56,13.84
2023,4,Entre Ríos,107,4408,37150,54377,16673,7236,164304,14382,298637,101.18,41794,159575,61667,24036,11565,298637,298617,20,298637,69.94,20.91
2023,4,Formosa,85,179,21856,11563,4545,272,23152,350,62002,83.35,10252,18325,16179,17061,185,62002,62002,0,62002,39.23,9.98
2023,4,Jujuy,58,1343,15359,11724,28741,272,58543,1980,118020,46.2,11669,51083,49947,4105,1216,118020,118020,0,118020,57.78,14.77
2023,4,La Pampa,71,1330,46716,17278,14556,5511,34254,1610,121326,25.61,6844,59063,34331,19982,1106,121326,121164,162,121326,99.96,32.93
2023,4,La Rioja,18,435,1483,1786,24838,4709,54452,0,87721,64.18,3296,55441,22559,6395,30,87721,87717,4,87721,80.22,21.35
2023,4,Mendoza,104,2945,35976,20902,30051,7781,196093,5499,299351,49.46,17676,70920,182220,27609,926,299351,298621,730,299351,52.15,14.55
2023,4,Misiones,51,3248,32287,21522,11338,3850,119112,8925,200333,93.65,25840,79000,75382,12928,7183,200333,200333,0,200333,56.27,15.33
2023,4,Neuquén,136,998,35431,13485,10435,2933,81033,20176,164627,99.63,24122,73784,41583,24390,748,164627,164188,439,164627,79.91,23.78
2023,4,Río Negro,112,1039,27223,16608,18343,24693,64813,15586,168417,74.37,21192,49789,64323,17284,15829,168417,167902,515,168417,70.26,21.61
2023,4,Salta,114,1154,28069,65938,3735,66,98971,6685,204732,83.04,26765,98853,60800,11806,6508,204732,204727,5,204732,56.98,13.8
2023,4,San Juan,24,2021,21157,12882,12489,1343,30645,22649,103210,24.78,12669,18543,42691,22351,6956,103210,102963,247,103210,50.08,12.75
2023,4,San Luis,60,628,11317,23754,8952,75907,33150,917,154685,174.59,4037,41260,30135,78954,299,154685,154520,165,154685,102.07,29.21
2023,4,Santa Cruz,50,500,7764,10783,11558,3628,19314,33434,87031,36.77,7768,15669,55246,7687,661,87031,86844,187,87031,73.75,21.94
2023,4,Santa Fe,468,6845,82343,164019,59636,22135,557629,16426,909501,99.81,97004,398670,355762,44521,13544,909501,909395,106,909501,79.75,25.08
2023,4,Santiago Del Estero,180,1173,13018,53980,24514,5794,23641,930,123230,44.22,8290,80692,24271,7057,2920,123230,123228,2,123230,49.08,12.18
2023,4,Tierra Del Fuego,22,834,10283,12618,19536,6085,4342,7879,61599,17.92,9357,48071,3682,157,332,61599,61294,305,61599,110.49,32.75
2023,4,Tucumán,39,1089,18850,22817,24476,1583,196919,562,266335,101.55,41318,20267,199876,4357,517,266335,266308,27,266335,61.04,15.12
2023,3,Buenos Aires,27440,24820,242010,241310,246076,112159,3951660,122762,4968237,146.84,237705,2784175,1740239,137921,68197,4968237,4962337,5900,4968237,80.64,27.5
2023,3,Capital Federal,516,4690,28089,50899,34061,6020,1343709,0,1467984,218.13,60765,1205339,167428,4629,29823,1467984,1465934,2050,1467984,116.4,47.6
2023,3,Catamarca,71,224,3194,3893,4634,2124,60123,92,74355,87.9,7164,11066,54650,1384,91,74355,74354,1,74355,68.55,17.44
2023,3,Chaco,236,462,14076,12874,6895,2970,100544,4089,142146,107.5,16420,60058,54993,8267,2408,142146,142141,5,142146,42.87,11.46
2023,3,Chubut,111,1470,44434,30908,24394,19608,30565,16578,168068,19.26,26352,75460,25827,30521,9908,168068,167211,857,168068,84.23,25.82
2023,3,Córdoba,99,8691,126420,96257,52428,26058,742447,16934,1069334,111.5,125050,453994,417338,62514,10438,1069334,1069271,63,1069334,90.05,27.57
2023,3,Corrientes,67,2985,20810,20906,5494,4577,97014,7976,159829,99.64,24253,83897,36032,10407,5240,159829,159826,3,159829,52.78,13.9
2023,3,Entre Ríos,107,4510,38962,49979,20312,22941,156482,0,293293,96.26,45384,157464,54794,24481,11170,293293,293273,20,293293,68.84,20.58
2023,3,Formosa,85,208,21919,11697,5045,274,21727,359,61314,80.29,11230,18053,14904,16899,228,61314,61314,0,61314,38.86,9.89
2023,3,Jujuy,58,1436,15685,11983,28956,288,56943,2028,117377,44.55,12627,51082,48350,4067,1251,117377,117377,0,117377,57.61,14.73
2023,3,La Pampa,71,1358,47914,18238,14676,4081,31970,1613,119921,24.21,6844,59063,32891,20014,1109,119921,119759,162,119921,99.0,32.62
2023,3,La Rioja,18,459,1617,1989,24847,4798,53973,0,87701,63.84,3726,55494,22054,6395,32,87701,87697,4,87701,80.44,21.41
2023,3,Mendoza,104,2948,36236,20942,30636,8032,193600,5524,298022,46.96,17677,73066,178719,27609,951,298022,297292,730,298022,52.03,14.52
2023,3,Misiones,51,3302,32953,22315,11900,3862,113860,8892,197135,91.49,27934,79087,70003,12928,7183,197135,197135,0,197135,55.51,15.12
2023,3,Neuquén,170,981,37758,13937,11582,2377,84209,13259,164273,96.57,24527,73329,39243,24085,3089,164273,163834,439,164273,79.97,23.8
2023,3,Río Negro,112,1061,29201,15014,21182,22752,59206,14957,163485,70.93,22422,50429,56668,16864,17102,163485,162970,515,163485,68.4,21.04
2023,3,Salta,115,1190,29305,67060,4059,78,97627,6799,206233,80.8,29113,98324,59914,12337,6545,206233,206228,5,206233,57.57,13.94
2023,3,San Juan,24,2021,21090,12882,12564,1440,31081,22628,103730,24.45,12669,19376,42383,22317,6985,103730,103483,247,103730,50.45,12.85
2023,3,San Luis,60,628,11398,23818,10926,74914,18688,8484,148916,104.97,4037,41624,24525,78431,299,148916,148751,165,148916,98.55,28.2
2023,3,Santa Cruz,50,6722,10612,10853,9565,3643,6542,0,47987,15.67,8376,23931,11270,3660,750,47987,47800,187,47987,40.89,12.17
2023,3,Santa Fe,468,7174,85897,168711,65489,20333,534474,17806,900352,97.39,108503,397854,336013,44545,13437,900352,900246,106,900352,79.09,24.87
2023,3,Santiago Del Estero,180,1199,15100,54503,28456,806,20734,950,121928,41.46,9412,80919,21745,6916,2936,121928,121926,2,121928,48.67,12.08
2023,3,Tierra Del Fuego,22,834,10550,12731,20384,5150,4040,5020,58731,17.17,9357,45203,3682,157,332,58731,58426,305,58731,105.95,31.41
2023,3,Tucumán,39,1236,20378,25026,25523,1633,192051,671,266557,98.85,46348,20545,195053,4088,523,266557,266530,27,266557,61.26,15.17
2023,2,Buenos Aires,28007,24674,246067,253078,245505,107502,3883235,97420,4885488,138.35,265537,2766463,1645945,138405,69138,4885488,4879442,6046,4885488,79.67,27.1
2023,2,Capital Federal,516,4422,27827,54111,34364,6189,1330249,0,1457678,208.01,68348,1218631,136295,4504,29900,1457678,1455578,2100,1457678,115.48,47.27
2023,2,Catamarca,71,226,3329,4076,4788,2285,58048,167,72990,86.13,7637,10700,53177,1384,92,72990,72989,1,72990,67.42,17.15
2023,2,Chaco,236,475,14630,14176,7446,3008,97897,3987,141855,105.45,19115,59944,51955,8267,2574,141855,141850,5,141855,42.87,11.46
2023,2,Chubut,109,1467,45798,31021,24750,17708,28859,14249,163961,18.58,33702,73689,16111,30521,9938,163961,163078,883,163961,82.49,25.28
2023,2,Córdoba,99,8627,126496,99026,52240,25144,712647,43472,1067751,111.82,129303,453924,411703,62391,10430,1067751,1067686,65,1067751,90.13,27.59
2023,2,Corrientes,67,2945,21781,22144,5937,4593,93048,7779,158294,97.21,26821,82977,32834,10407,5255,158294,158290,4,158294,52.37,13.79
2023,2,Entre Ríos,107,4377,39693,49240,20231,22661,137638,0,273947,89.37,46503,142562,49251,24461,11170,273947,273927,20,273947,64.43,19.26
2023,2,Formosa,84,186,21944,11825,5202,300,20428,381,60350,77.32,11934,17678,13698,16813,227,60350,60350,0,60350,38.32,9.75
2023,2,Jujuy,58,1440,16174,12344,29181,300,55867,2078,117442,43.56,13749,51082,47289,4067,1255,117442,117442,0,117442,57.78,14.78
2023,2,La Pampa,68,1365,48635,18475,14999,4266,29134,1968,118910,22.78,7254,59101,31449,19993,1113,118910,118744,166,118910,98.35,32.4
2023,2,La Rioja,18,454,1719,2236,24737,4888,52920,0,86972,63.55,4152,55148,21245,6395,32,86972,86968,4,86972,80.01,21.3
2023,2,Mendoza,103,2945,36286,20985,33217,12649,176628,14863,297676,42.69,25299,71931,171857,27609,980,297676,296921,755,297676,52.09,14.54
2023,2,Misiones,51,3247,34144,22649,12055,3862,110815,8648,195471,90.55,28897,82058,64406,12927,7183,195471,195471,0,195471,55.18,15.03
2023,2,Neuquén,168,984,38006,13946,13275,6649,85749,2969,161746,93.97,26379,73040,35171,24046,3110,161746,161289,457,161746,78.97,23.5
2023,2,Río Negro,111,1070,29535,15050,20561,22752,58834,15466,163379,70.76,26390,49684,53325,16864,17116,163379,162848,531,163379,68.56,21.09
2023,2,Salta,114,1042,29687,67966,4523,94,95063,6839,205328,79.1,30666,97501,58275,12337,6549,205328,205323,5,205328,57.48,13.92
2023,2,San Juan,24,2020,21766,12810,13276,10042,21369,16142,97449,20.39,21483,20200,25217,23545,7004,97449,97189,260,97449,47.52,12.1
2023,2,San Luis,60,624,11543,23932,12756,74914,15090,1829,140748,103.84,4937,41949,15595,77960,307,140748,140575,173,140748,93.41,26.73
2023,2,Santa Cruz,49,6720,10609,11253,9733,3667,6315,256,48602,15.48,9019,23896,11269,3660,758,48602,48410,192,48602,41.66,12.39
2023,2,Santa Fe,468,7021,89275,172672,71957,24123,499408,30890,895814,94.87,126344,399669,311166,44134,14501,895814,895706,108,895814,78.83,24.79
2023,2,Santiago Del Estero,178,1152,16847,55281,26520,766,16066,999,117809,37.62,10629,80086,17244,6916,2934,117809,117807,2,117809,47.14,11.7
2023,2,Tierra Del Fuego,22,831,10556,12748,20962,4707,3901,4908,58635,16.92,12392,45224,525,157,337,58635,58325,310,58635,106.38,31.54
2023,2,Tucumán,39,1091,21163,27206,25910,1661,185887,645,263602,96.69,50019,20012,188986,4060,525,263602,263573,29,263602,60.75,15.05
2023,1,Buenos Aires,28615,25137,249864,264388,241923,104495,3810940,95566,4820928,116.18,304583,2761043,1551074,132458,71770,4820928,4814729,6199,4820928,79.0,26.81
2023,1,Capital Federal,516,4500,28668,60061,34974,7859,1305284,106867,1548729,188.65,132149,1223930,156222,4605,31823,1548729,1546584,2145,1548729,122.59,50.23
2023,1,Catamarca,71,221,2192,4352,3794,2607,55944,2311,71492,87.41,6980,10655,50230,1384,2243,71492,71491,1,71492,66.17,16.83
2023,1,Chaco,236,544,15113,15190,7729,3020,96663,3947,142442,104.33,21243,60727,49756,8142,2574,142442,142437,5,142442,43.15,11.53
2023,1,Chubut,109,1598,45794,30947,25072,17700,28259,20574,170053,18.36,45448,73525,9815,30521,10744,170053,169149,904,170053,85.89,26.32
2023,1,Córdoba,99,8844,131774,103063,57176,24960,690566,33490,1049972,109.57,136976,455139,386297,61066,10494,1049972,1049904,68,1049972,88.84,27.2
2023,1,Corrientes,67,3074,22517,23420,6349,4601,88008,8984,157020,94.8,29577,81116,30016,11071,5240,157020,157016,4,157020,52.05,13.71
2023,1,Entre Ríos,107,4525,41215,51664,20667,22680,134020,0,274878,86.71,51084,141699,44508,26415,11172,274878,274856,22,274878,64.79,19.37
2023,1,Formosa,84,192,22016,11922,6229,273,19567,702,60985,73.96,12502,17421,13345,17490,227,60985,60985,0,60985,38.79,9.87
2023,1,Jujuy,58,1598,16842,12856,29386,306,54859,2076,117981,42.75,15306,51082,46271,4067,1255,117981,117981,0,117981,58.2,14.88
2023,1,La Pampa,68,1399,50313,11510,10525,4423,21308,16958,116504,20.09,7049,59944,28126,20103,1282,116504,116333,171,116504,96.55,31.81
2023,1,La Rioja,18,502,1892,2470,24551,4949,52023,0,86405,63.13,4652,54604,20722,6395,32,86405,86401,4,86405,79.74,21.23
2023,1,Mendoza,103,2945,32767,20813,30657,15046,169502,21186,293019,41.45,37646,73678,152534,27592,1569,293019,292242,777,293019,51.4,14.34
2023,1,Misiones,51,3448,34762,21817,11881,3881,106601,8244,190685,89.81,30455,82834,56619,12896,7881,190685,190685,0,190685,53.97,14.7
2023,1,Neuquén,168,986,38414,13933,13192,6195,85257,2267,160412,93.42,28030,72639,32296,23937,3510,160412,159944,468,160412,78.55,23.38
2023,1,Río Negro,111,1076,29515,15171,18697,12079,57910,29772,164331,74.4,33604,49128,45329,16857,19413,164331,163783,548,164331,69.16,21.27
2023,1,Salta,114,1096,30564,69436,4822,104,92512,6778,205426,76.85,33427,96922,56259,12269,6549,205426,205421,5,205426,57.67,13.97
2023,1,San Juan,24,2020,30051,11221,14799,10268,21544,11840,101767,18.7,38568,21215,12798,21912,7274,101767,101486,281,101767,49.75,12.67
2023,1,San Luis,60,624,11680,24133,13659,75904,6050,3353,135463,55.85,6283,42789,6952,78954,485,135463,135281,182,135463,90.17,25.8
2023,1,Santa Cruz,51,6810,11528,11380,9861,3697,5990,1044,50361,14.98,9702,23839,12217,3660,943,50361,50163,198,50361,43.42,12.92
2023,1,Santa Fe,468,7655,98198,180708,75061,26306,479777,18101,886274,92.22,138935,405618,283988,43487,14246,886274,886164,110,886274,78.13,24.57
2023,1,Santiago Del Estero,178,1186,21551,57189,21277,734,15447,993,118555,36.27,11642,80407,16656,6916,2934,118555,118553,2,118555,47.55,11.8
2023,1,Tierra Del Fuego,22,831,10944,13048,21348,3959,2386,4575,57113,14.58,12754,43146,405,157,651,57113,56801,312,57113,104.23,30.9
2023,1,Tucumán,39,1237,23379,29629,25565,1723,164402,15126,261100,95.79,55822,19482,180976,4293,527,261100,261070,30,261100,60.34,14.95
2022,4,Buenos Aires,28934,23347,259866,281550,244555,98670,3760109,97634,4794665,111.0,325908,2767247,1499149,129910,72451,4794665,4788466,6199,4794665,78.94,26.72
2022,4,Capital Federal,516,5096,31320,64653,36336,8116,1299117,106772,1551926,182.86,138753,1238196,138548,4603,31826,1551926,1549781,2145,1551926,122.73,50.35
2022,4,Catamarca,71,315,2716,5028,4638,3122,52739,2280,70909,83.33,8952,10998,47337,1379,2243,70909,70908,1,70909,65.77,16.73
2022,4,Chaco,461,771,16067,17846,6704,3039,94866,3909,143663,104.02,24582,61265,47285,7957,2574,143663,143658,5,143663,43.62,11.66
2022,4,Chubut,109,1614,46457,31007,34728,15770,19048,20026,168759,15.92,45450,73923,9815,30721,8850,168759,167855,904,168759,85.57,26.23
2022,4,Córdoba,99,9929,143686,108195,63120,20691,686330,17610,1049660,108.77,152265,456947,367393,61631,11424,1049660,1049592,68,1049660,89.03,27.26
2022,4,Corrientes,67,3282,22647,24858,7025,3770,85806,7998,155453,94.72,34038,80283,26752,9082,5298,155453,155449,4,155453,51.64,13.6
2022,4,Entre Ríos,107,4722,45629,46700,20927,22483,130406,0,270974,87.47,55507,135746,40798,26414,12509,270974,270952,22,270974,64.01,19.14
2022,4,Formosa,84,245,22458,12391,6724,310,18930,698,61840,72.03,13735,17068,13118,17692,227,61840,61840,0,61840,39.41,10.03
2022,4,Jujuy,58,1763,18652,14070,36430,335,46910,0,118218,39.32,17880,52390,42626,4067,1255,118218,118218,0,118218,58.46,14.95
2022,4,La Pampa,68,1687,52618,10334,9167,4479,19783,16028,114164,19.1,7785,60566,24552,19995,1266,114164,113993,171,114164,94.8,31.23
2022,4,La Rioja,18,595,2531,3010,24435,5029,50644,0,86262,61.0,6120,54387,19328,6395,32,86262,86258,4,86262,79.86,21.26
2022,4,Mendoza,103,2954,35541,20355,35935,14909,161163,21144,292104,38.76,37655,77814,147080,27607,1948,292104,291327,777,292104,51.36,14.33
2022,4,Misiones,51,3510,35622,21373,12196,3182,101745,8590,186269,91.24,33204,87202,46885,11075,7903,186269,186269,0,186269,52.85,14.39
2022,4,Neuquén,168,994,38814,13960,13008,5739,85247,2250,160180,95.37,28609,72679,31567,23815,3510,160180,159712,468,160180,78.67,23.41
2022,4,Río Negro,111,1081,32053,13931,20442,7335,57495,29644,162092,75.31,34043,48401,43958,16277,19413,162092,161544,548,162092,68.42,21.04
2022,4,Salta,114,1197,31530,71105,5036,117,90014,6747,205860,75.93,36939,97023,53470,11884,6544,205860,205855,5,205860,57.96,14.04
2022,4,San Juan,24,2027,30069,11247,20440,8188,19991,11840,103826,16.39,38570,22913,12491,21912,7940,103826,103545,281,103826,50.88,12.96
2022,4,San Luis,60,624,11785,24684,13981,78506,2227,3353,135220,30.67,6283,43460,3409,81557,511,135220,135028,192,135220,90.27,25.83
2022,4,Santa Cruz,51,6810,11616,11509,10374,3236,5559,1048,50203,14.33,9702,23876,12217,3746,662,50203,50005,198,50203,43.53,12.95
2022,4,Santa Fe,468,9374,115767,194420,73345,22899,453078,18340,887691,90.3,163621,412157,248558,44113,19242,887691,887581,110,887691,78.4,24.65
2022,4,Santiago Del Estero,178,1267,26183,58136,17735,661,14345,989,119494,34.4,13577,80955,15117,6911,2934,119494,119492,2,119494,48.05,11.92
2022,4,Tierra Del Fuego,22,902,11649,13634,21365,3612,1812,2264,55260,13.48,12754,41293,405,157,651,55260,54948,312,55260,101.44,30.07
2022,4,Tucumán,39,1562,29996,35425,26369,1375,153538,15118,263422,88.33,69441,20668,168717,4069,527,263422,263392,30,263422,61.04,15.12
2022,3,Buenos Aires,29985,27709,290315,297915,267044,124190,3618689,65821,4721668,70.19,339648,2748325,1436433,126846,70416,4721668,4715469,6199,4721668,78.11,26.37
2022,3,Capital Federal,517,5742,34371,67829,51946,28692,1253105,105477,1547679,101.05,140791,1240125,129218,5758,31787,1547679,1545534,2145,1547679,122.28,50.22
2022,3,Catamarca,71,384,3107,5389,5099,3737,50298,2208,70293,60.99,10010,10495,46224,1329,2235,70293,70292,1,70293,65.33,16.62
2022,3,Chaco,461,987,16782,18938,8049,15828,79390,3711,144146,53.21,27164,61800,44645,8178,2359,144146,144141,5,144146,43.86,11.72
2022,3,Chubut,109,1444,45707,30940,34682,15309,17563,20024,165778,15.57,45377,72212,9574,29784,8831,165778,164874,904,165778,84.38,25.86
2022,3,Córdoba,99,11312,153324,111615,70989,27112,650344,13873,1038668,56.32,163770,465461,338570,61070,9797,1038668,1038600,68,1038668,88.31,27.04
2022,3,Corrientes,67,3865,23427,23948,7776,21706,56950,7107,144846,45.07,36508,77140,18619,7256,5323,144846,144842,4,144846,48.21,12.69
2022,3,Entre Ríos,107,5549,47210,46855,18263,32021,102195,16759,268959,42.49,60345,132952,36971,26098,12593,268959,268937,22,268959,63.67,19.04
2022,3,Formosa,97,307,23538,19545,6194,564,17704,589,68538,30.35,14470,25880,11041,16935,212,68538,68537,1,68538,43.76,11.14
2022,3,Jujuy,58,1879,19135,15254,36083,519,45895,0,118823,32.43,19257,52978,40172,4033,2383,118823,118823,0,118823,58.91,15.06
2022,3,La Pampa,68,1887,61540,9653,11592,5609,22731,3012,116092,18.1,7796,60078,23551,20216,4451,116092,115921,171,116092,96.59,31.82
2022,3,La Rioja,18,689,2842,3375,24219,5331,50390,0,86864,44.3,6842,53899,19697,6395,31,86864,86860,4,86864,80.66,21.47
2022,3,Mendoza,103,2953,44232,21977,48201,17243,150043,4771,289523,34.16,37659,78858,142615,27625,2766,289523,288746,777,289523,51.03,14.24
2022,3,Misiones,51,3749,36628,20758,12676,19615,80330,8350,182157,49.3,35513,88902,39046,11074,7622,182157,182157,0,182157,51.82,14.11
2022,3,Neuquén,134,991,38485,14080,9200,6700,78713,14858,163161,47.81,29352,75815,29396,27482,1116,163161,162693,468,163161,80.37,23.92
2022,3,Río Negro,111,1221,32936,17860,27934,13629,42596,24271,160558,34.13,35552,48260,41017,16760,18969,160558,160010,548,160558,67.98,20.91
2022,3,Salta,114,1490,32923,71199,5662,1001,85661,6491,204541,41.33,40006,96984,50254,10082,7215,204541,204536,5,204541,57.76,13.99
2022,3,San Juan,24,2027,30324,11247,22157,6780,19221,11619,103399,15.84,38570,22723,12328,21860,7918,103399,103118,281,103399,50.8,12.94
2022,3,San Luis,60,307,6563,20813,12061,67438,13,14815,122070,19.33,6860,29363,248,70614,14985,122070,121888,182,122070,81.74,23.39
2022,3,Santa Cruz,52,6841,12342,11313,11378,2333,4604,647,49510,12.6,10170,24047,10815,3896,582,49510,49312,198,49510,43.19,12.85
2022,3,Santa Fe,468,11132,132709,198588,70897,57455,396352,20209,887810,45.15,183740,426255,215189,43079,19547,887810,887700,110,887810,78.55,24.7
2022,3,Santiago Del Estero,178,1384,28357,58982,16087,910,12342,792,119032,17.69,15385,80937,13170,6618,2922,119032,119030,2,119032,47.98,11.91
2022,3,Tierra Del Fuego,22,831,12002,14815,20102,1752,1021,3351,53896,11.01,12754,39963,403,125,651,53896,53584,312,53896,99.51,29.5
2022,3,Tucumán,39,2047,32571,39018,25214,4348,159600,280,263117,53.36,77738,18518,162345,3997,519,263117,263087,30,263117,61.14,15.14
2022,2,Buenos Aires,30639,28323,295238,307554,273954,129869,3535757,65849,4667183,65.5,350652,2719613,1399043,126847,71028,4667183,4660984,6199,4667183,77.58,26.13
2022,2,Capital Federal,517,5980,36036,72434,55372,31571,1229254,105607,1536771,93.97,145491,1232226,121506,5757,31791,1536771,1534626,2145,1536771,121.31,49.87
2022,2,Catamarca,71,413,3678,6155,7165,3393,43926,2207,67008,56.56,11928,9430,42087,1329,2234,67008,67007,1,67008,62.4,15.87
2022,2,Chaco,461,1047,17603,20109,8391,15974,76271,3708,143564,50.61,29552,61284,42194,8178,2356,143564,143559,5,143564,43.79,11.7
2022,2,Chubut,109,1444,45804,31217,34290,14526,15394,20021,162805,14.91,45377,69242,9574,29784,8828,162805,161901,904,162805,83.19,25.5
2022,2,Córdoba,99,11971,160486,120485,71923,28645,619400,13426,1026435,53.51,179181,467595,308895,61107,9657,1026435,1026367,68,1026435,87.48,26.78
2022,2,Corrientes,67,3937,24253,24842,8001,21719,55071,7107,144997,43.31,38468,75769,18181,7256,5323,144997,144993,4,144997,48.35,12.73
2022,2,Entre Ríos,107,5656,48637,48557,18512,32355,98769,16759,269352,40.03,63794,131029,35839,26098,12592,269352,269330,22,269352,63.9,19.1
2022,2,Formosa,97,407,23834,19706,6330,591,16326,590,67881,28.47,15397,25487,9875,16910,212,67881,67881,0,67881,43.42,11.05
2022,2,Jujuy,58,1829,19458,15790,37786,549,37391,2453,115314,29.39,20303,54495,34184,3955,2377,115314,115314,0,115314,57.32,14.66
2022,2,La Pampa,68,1887,62546,9842,11800,5247,17125,3012,111527,16.07,7796,59273,22994,20200,1264,111527,111356,171,111527,92.98,30.63
2022,2,La Rioja,18,728,3179,3890,23814,5481,48920,0,86030,43.28,7759,52656,19189,6395,31,86030,86026,4,86030,80.14,21.33
2022,2,Mendoza,103,2954,44961,22557,64138,19543,121366,3940,279562,29.72,37663,77504,135504,26964,1927,279562,278785,777,279562,49.39,13.78
2022,2,Misiones,51,3808,37254,21712,12774,19757,75107,8350,178813,46.23,37208,89260,33649,11074,7622,178813,178813,0,178813,51.0,13.89
2022,2,Neuquén,134,999,38826,15066,9205,2039,76982,18717,161968,46.53,29749,74905,28824,27371,1119,161968,161500,468,161968,80.02,23.82
2022,2,Río Negro,111,1227,33364,17938,27168,13714,41972,24270,159764,33.26,36050,47040,40946,16760,18968,159764,159216,548,159764,67.85,20.87
2022,2,Salta,114,1530,33732,72661,6012,1156,81478,6494,203177,38.77,42665,96178,47076,10068,7190,203177,203172,5,203177,57.54,13.94
2022,2,San Juan,24,2027,30385,11276,24649,3728,16701,11617,100407,14.44,38570,19734,12328,21859,7916,100407,100126,281,100407,49.46,12.6
2022,2,San Luis,60,306,6840,21217,11052,67438,13,14815,121741,19.32,6860,29034,248,70614,14985,121741,121559,182,121741,81.76,23.4
2022,2,Santa Cruz,52,6841,12348,11369,11885,2454,3592,644,49185,11.81,10170,23725,10815,3896,579,49185,48987,198,49185,43.15,12.84
2022,2,Santa Fe,468,11757,138534,204381,74133,58114,373888,17584,878859,42.01,198492,428233,189503,43081,19550,878859,878749,110,878859,77.9,24.5
2022,2,Santiago Del Estero,178,1401,29581,59931,14606,883,10672,792,118044,16.34,16561,80338,11605,6618,2922,118044,118042,2,118044,47.7,11.84
2022,2,Tierra Del Fuego,22,831,12052,14828,19968,1712,1006,3351,53770,10.97,12754,39837,403,125,651,53770,53458,312,53770,99.86,29.6
2022,2,Tucumán,39,2195,34461,43513,23634,4863,145541,281,254527,50.09,85893,15327,148823,3997,487,254527,254497,30,254527,59.31,14.69
2022,1,Buenos Aires,31591,30056,313382,321756,290127,161183,3381049,26280,4555424,62.51,392045,2728865,1242121,125521,66872,4555424,4549131,6293,4555424,76.08,25.56
2022,1,Capital Federal,527,5575,39918,77390,61053,43289,1188072,1717,1417541,88.22,102290,1217225,62308,5784,29934,1417541,1415378,2163,1417541,111.8,46.01
2022,1,Catamarca,71,456,4386,7009,8773,3761,35715,2207,62378,51.22,14181,15517,29118,1328,2234,62378,62377,1,62378,58.21,14.81
2022,1,Chaco,461,1099,16888,21235,20898,13012,62946,7580,144119,45.84,32391,64546,36662,8164,2356,144119,144114,5,144119,44.06,11.78
2022,1,Chubut,113,1677,61369,31856,33080,13871,14055,15607,171628,13.4,44133,66667,9184,30592,21052,171628,170701,927,171628,88.05,26.99
2022,1,Córdoba,100,12782,165922,126009,73967,34892,577027,13104,1003803,49.89,195610,501799,235838,60843,9713,1003803,1003729,74,1003803,85.76,26.26
2022,1,Corrientes,67,4029,24563,25665,27077,10452,43631,7094,142578,38.11,40462,79093,10875,6774,5374,142578,142574,4,142578,47.64,12.55
2022,1,Entre Ríos,107,5745,50075,49620,42294,21578,81757,16750,267926,35.59,67159,138986,23091,26098,12592,267926,267904,22,267926,63.7,19.05
2022,1,Formosa,97,448,24113,6945,6613,716,15028,588,54548,30.28,16397,15927,5146,16876,202,54548,54548,0,54548,34.96,8.9
2022,1,Jujuy,58,1761,22141,16321,37923,576,35287,2442,116509,27.69,21307,60616,25949,4662,3975,116509,116509,0,116509,58.06,14.85
2022,1,La Pampa,301,2223,62812,9869,12044,5250,14400,2833,109732,14.84,8003,58978,21739,19903,1109,109732,109560,172,109732,91.66,30.2
2022,1,La Rioja,18,778,3576,4692,23624,5645,45970,0,84303,41.37,9103,59228,9546,6395,31,84303,84299,4,84303,78.77,20.97
2022,1,Mendoza,114,3355,51230,26407,74178,21566,95048,3287,275185,26.2,49464,74145,123228,26969,1379,275185,274399,786,275185,48.74,13.6
2022,1,Misiones,51,3873,35655,22261,26855,15854,58610,8349,171508,41.87,39147,91752,25178,7807,7624,171508,171508,0,171508,49.04,13.36
2022,1,Neuquén,137,1123,39856,15623,11163,2654,71238,7885,149679,43.05,28443,73200,24193,23098,745,149679,149208,471,149679,74.17,22.08
2022,1,Río Negro,116,1383,35565,18859,26926,14144,37729,22652,157374,31.09,38662,45366,38037,16815,18494,157374,156821,553,157374,67.04,20.62
2022,1,Salta,114,1725,35576,68246,6313,2214,76838,6489,197515,36.71,44714,98667,40994,5950,7190,197515,197510,5,197515,56.11,13.59
2022,1,San Juan,26,2269,32356,11914,25144,2088,11916,2465,88178,11.99,34038,14449,11294,20723,7674,88178,87888,290,88178,43.55,11.09
2022,1,San Luis,61,643,8287,3837,9802,68612,13,28589,119844,20.95,7987,11296,31,71809,28721,119844,119659,185,119844,80.72,23.1
2022,1,Santa Cruz,51,6898,12710,11502,12277,2628,2551,485,49102,10.89,10537,23420,10766,3974,405,49102,48898,204,49102,43.34,12.89
2022,1,Santa Fe,468,12435,143796,208361,84787,58018,344170,18444,870479,38.89,213486,444609,146552,45261,20571,870479,870364,115,870479,77.3,24.31
2022,1,Santiago Del Estero,178,1401,30220,61170,13542,849,8309,792,116461,14.5,18118,87979,1093,6349,2922,116461,116459,2,116461,47.17,11.71
2022,1,Tierra Del Fuego,24,894,12849,15640,18034,1767,982,2421,52611,10.73,13031,38700,416,124,340,52611,52298,313,52611,98.29,29.14
2022,1,Tucumán,39,2212,36028,46961,21014,5211,133846,273,245584,47.24,92532,62396,86174,3995,487,245584,245554,30,245584,57.39,14.22
2021,4,Buenos Aires,37821,11026,352950,331292,297296,196021,3259793,22958,4509157,60.21,426325,2706506,1176024,126887,73415,4509157,4502772,6385,4509157,75.66,25.36
2021,4,Capital Federal,563,1695,47133,81899,66135,66755,1147939,0,1412119,82.95,111360,1205128,60005,5679,29947,1412119,1409935,2184,1412119,111.27,45.85
2021,4,Catamarca,71,0,6038,7855,9804,3262,29827,2233,59090,46.38,16385,13858,25100,1512,2235,59090,59089,1,59090,55.25,14.05
2021,4,Chaco,461,112,18845,22678,21937,13692,58435,7585,143745,42.34,35548,63145,34688,8005,2359,143745,143740,5,143745,44.05,11.77
2021,4,Chubut,126,1294,63698,39568,31175,5780,2904,15763,160308,9.08,46361,57412,9655,28041,18839,160308,159364,944,160308,82.57,25.31
2021,4,Córdoba,100,2479,184548,130892,76246,41198,538700,12607,986770,46.36,212011,487489,217214,61277,8779,986770,986693,77,986770,84.51,25.87
2021,4,Corrientes,67,645,28830,26368,22922,10087,39911,7082,135912,35.77,42523,71183,10138,6778,5290,135912,135908,4,135912,45.51,11.98
2021,4,Entre Ríos,107,3024,56043,49636,38295,24068,77290,16583,265046,33.32,70459,133387,23452,25022,12726,265046,265024,22,265046,63.16,18.88
2021,4,Formosa,84,0,22908,6983,6811,1135,13775,1967,53663,28.76,17211,15111,5151,16018,172,53663,53663,0,53663,34.45,8.77
2021,4,Jujuy,58,175,22446,16793,38134,564,33421,2324,113915,27.14,22330,60511,24156,2927,3991,113915,113915,0,113915,56.92,14.56
2021,4,La Pampa,301,493,64840,9082,12259,4821,12184,3027,107007,13.85,8175,58000,20192,19286,1354,107007,106834,173,107007,89.57,29.51
2021,4,La Rioja,18,1,5018,5437,23559,5671,43424,0,83128,39.7,10387,56651,9446,6613,31,83128,83124,4,83128,77.92,20.74
2021,4,Mendoza,156,1463,66428,30308,75214,18621,75031,366,267587,22.23,59842,71553,109667,24666,1859,267587,266783,804,267587,47.51,13.26
2021,4,Misiones,51,5,41916,23554,26721,15954,54596,8335,171132,38.9,41778,92068,22035,7649,7602,171132,171132,0,171132,49.06,13.36
2021,4,Neuquén,140,940,42313,13264,10515,3310,69217,7767,147466,40.09,29175,72761,23253,21531,746,147466,146989,477,147466,73.3,21.82
2021,4,Río Negro,156,1174,38373,19878,31255,4130,36142,22645,153753,27.2,42037,44495,32212,16558,18451,153753,153189,564,153753,65.69,20.21
2021,4,Salta,114,20,40673,69324,6642,3535,72622,6475,199405,33.94,46972,99808,39555,5882,7188,199405,199399,6,199405,56.81,13.76
2021,4,San Juan,44,1442,28906,10955,23978,398,9800,4435,79958,11.05,35868,13102,11072,11423,8493,79958,79667,291,79958,39.59,10.08
2021,4,San Luis,62,264,8550,4276,9107,67363,9,29218,118849,20.91,8472,11064,30,70560,28723,118849,118662,187,118849,80.3,22.98
2021,4,Santa Cruz,52,297,20305,11641,13054,1770,876,491,48486,8.99,10790,22902,10031,4346,417,48486,48276,210,48486,43.05,12.81
2021,4,Santa Fe,467,581,169706,206856,85690,62349,322015,18777,866441,36.02,233427,444373,128856,43556,16229,866441,866265,176,866441,77.09,24.24
2021,4,Santiago Del Estero,178,909,31915,61524,12205,800,7537,793,115861,13.84,19032,86563,1088,6256,2922,115861,115859,2,115861,47.05,11.68
2021,4,Tierra Del Fuego,26,385,13505,16534,16562,1748,1017,2580,52357,10.7,13317,38148,426,124,342,52357,52042,315,52357,98.4,29.17
2021,4,Tucumán,39,97,37321,48736,21023,5326,125857,240,238639,45.15,97830,59022,78790,2511,486,238639,238609,30,238639,55.93,13.85
2021,3,Buenos Aires,37193,31149,1108940,248153,141383,192797,2482266,9728,4251609,56.26,585729,2595485,885613,120228,64554,4251609,4246425,5184,4251609,71.68,23.97
2021,3,Capital Federal,295,603,156978,67013,39785,73502,1075229,0,1413405,77.71,142902,1192107,42966,6059,29371,1413405,1411797,1608,1413405,111.27,45.9
2021,3,Catamarca,71,0,6755,8428,10517,1659,26618,2206,56254,43.43,18413,11709,22331,1568,2233,56254,56253,1,56254,52.71,13.41
2021,3,Chaco,301,112,22545,20986,23852,14412,49705,7958,139871,39.11,38258,63659,27583,8018,2353,139871,139868,3,139871,42.96,11.48
2021,3,Chubut,104,105,89168,26281,18538,5320,1643,14907,156066,8.18,49269,55794,8946,23376,18681,156066,155266,800,156066,80.71,24.74
2021,3,Córdoba,99,2452,204989,141285,65050,47198,476459,9256,946788,41.93,229275,477223,167495,57617,15178,946788,946726,62,946788,81.28,24.89
2021,3,Corrientes,67,645,29629,28478,24792,9687,35468,5053,133819,32.17,44805,69403,7542,6766,5303,133819,133816,3,133819,44.9,11.82
2021,3,Entre Ríos,107,3024,61354,59776,39114,16284,67961,12755,260375,29.6,74443,128752,20485,23500,13195,260375,260360,15,260375,62.18,18.59
2021,3,Formosa,381,0,22778,7142,6978,1192,12707,1617,52795,26.69,18093,14111,4730,15690,171,52795,52795,0,52795,33.96,8.64
2021,3,Jujuy,48,175,23884,16417,37755,561,29917,2401,111158,25.98,23554,60758,19926,2952,3968,111158,111158,0,111158,55.69,14.24
2021,3,La Pampa,298,313,65063,7395,8737,4023,10506,4152,100487,12.99,9015,57881,17817,14479,1295,100487,100371,116,100487,84.28,27.77
2021,3,La Rioja,18,1,5366,5979,23315,4868,42613,0,82160,38.87,11329,54744,9444,6613,30,82160,82157,3,82160,77.26,20.57
2021,3,Mendoza,36,31,151871,12640,62628,7596,21087,50,255939,13.37,91474,71247,70579,21811,828,255939,255320,619,255939,45.55,12.71
2021,3,Misiones,51,5,41932,25099,26079,14792,42291,8279,158528,30.88,43230,89469,10969,7198,7662,158528,158528,0,158528,45.57,12.41
2021,3,Neuquén,112,327,57441,8566,6234,3631,57919,5579,139809,38.34,29650,73794,16455,19270,640,139809,139436,373,139809,69.71,20.75
2021,3,Río Negro,125,557,68991,3730,14880,2282,34011,20009,144585,25.4,47934,44519,18725,15031,18376,144585,144084,501,144585,61.97,19.06
2021,3,Salta,101,20,41431,70104,6962,3878,67010,6327,195833,31.21,49212,98318,36126,5724,6453,195833,195831,2,195833,55.96,13.55
2021,3,San Juan,18,333,59873,752,13250,338,278,4641,79483,7.04,40072,12922,6670,11372,8447,79483,79227,256,79483,39.46,10.05
2021,3,San Luis,60,0,11552,2405,6491,67942,22,29392,117864,21.7,8417,11884,27,68856,28680,117864,117716,148,117864,79.87,22.86
2021,3,Santa Cruz,50,0,30561,8365,6799,1788,678,735,48976,7.69,12347,22961,6328,4269,3071,48976,48779,197,48976,43.75,13.02
2021,3,Santa Fe,467,579,193207,201250,83941,55080,290793,16267,841584,33.13,245929,443156,93412,43447,15640,841584,841433,151,841584,75.02,23.59
2021,3,Santiago Del Estero,123,909,32752,61838,11274,801,6863,898,115458,13.35,19939,85535,909,6147,2928,115458,115457,1,115458,47.0,11.66
2021,3,Tierra Del Fuego,17,0,23723,13397,9782,1433,976,895,50223,9.52,12853,36958,6,16,390,50223,49934,289,50223,94.95,28.15
2021,3,Tucumán,32,97,39446,50293,21986,5300,115154,164,232472,42.1,104489,53868,70964,2408,743,232472,232447,25,232472,54.64,13.53
2021,2,Buenos Aires,37192,31178,1096049,244001,140322,236897,2337604,9108,4132351,52.76,603255,2503830,854173,113546,57547,4132351,4127167,5184,4132351,70.0,23.35
2021,2,Capital Federal,294,603,157558,73568,43859,86655,1037752,66,1400355,72.75,148989,1175097,41318,5580,29371,1400355,1398747,1608,1400355,110.14,45.49
2021,2,Catamarca,71,0,7219,9091,6828,4941,25388,2206,55744,42.19,20305,9426,22331,1449,2233,55744,55743,1,55744,52.34,13.31
2021,2,Chaco,301,112,23444,21574,24032,16069,47239,7958,140729,37.4,39826,62948,27584,8018,2353,140729,140726,3,140729,43.33,11.58
2021,2,Chubut,104,105,89639,22605,16604,3896,1112,5172,139237,7.68,49271,41497,6081,23682,18706,139237,138412,825,139237,72.29,22.16
2021,2,Córdoba,99,2452,201757,136516,66950,70824,442357,9925,930880,39.59,239780,467782,151855,55944,15519,930880,930818,62,930880,80.12,24.53
2021,2,Corrientes,67,645,29419,27037,24524,10059,32697,5053,129501,30.37,46648,67262,3731,6557,5303,129501,129498,3,129501,43.54,11.47
2021,2,Entre Ríos,107,3024,63518,55349,39468,18484,61605,16077,257632,27.62,77836,124957,17856,23786,13197,257632,257617,15,257632,61.66,18.44
2021,2,Formosa,381,0,22364,7310,7460,1341,11077,1618,51551,23.97,19571,12509,3610,15690,171,51551,51551,0,51551,33.23,8.46
2021,2,Jujuy,48,175,24182,16577,37908,607,29950,2401,111848,25.81,24738,60800,19611,2731,3968,111848,111848,0,111848,56.18,14.37
2021,2,La Pampa,298,554,64146,7769,8128,3399,9311,4062,97667,12.28,9017,57014,17132,13209,1295,97667,97551,116,97667,82.08,27.04
2021,2,La Rioja,18,1,5312,5971,23298,4825,42158,19,81602,38.53,11627,54255,9445,6245,30,81602,81599,3,81602,76.98,20.49
2021,2,Mendoza,36,31,137462,10886,56117,4403,20686,50,229671,13.47,91503,70834,44696,21811,827,229671,229052,619,229671,40.97,11.43
2021,2,Misiones,51,5,41643,25907,25811,16172,38308,8279,156176,28.68,44960,87861,10376,5317,7662,156176,156176,0,156176,45.01,12.26
2021,2,Neuquén,112,327,57713,8631,5871,5943,54008,5645,138250,36.11,30083,72690,15619,19218,640,138250,137877,373,138250,69.14,20.58
2021,2,Río Negro,125,557,69356,3663,15019,3867,31488,20009,144084,23.75,48189,43761,18727,15031,18376,144084,143583,501,144084,61.94,19.05
2021,2,Salta,101,20,42543,67012,7099,9654,58882,6328,191639,29.24,51396,96016,32050,5724,6453,191639,191637,2,191639,54.93,13.3
2021,2,San Juan,18,333,59989,784,12550,340,278,4641,78933,6.99,40072,12369,6673,11372,8447,78933,78677,256,78933,39.28,10.01
2021,2,San Luis,60,0,11752,2703,5418,65946,22,36917,122818,21.66,8417,11308,28,66860,36205,122818,122670,148,122818,83.48,23.89
2021,2,Santa Cruz,50,0,30595,8463,6888,1575,676,735,48982,7.63,12347,22967,6328,4269,3071,48982,48785,197,48982,44.01,13.1
2021,2,Santa Fe,467,896,202018,204077,80452,75195,262124,15371,840600,30.7,256741,431915,90424,43997,17523,840600,840449,151,840600,75.07,23.6
2021,2,Santiago Del Estero,123,909,32034,62224,10359,811,6064,1566,114090,12.72,20734,83770,909,5081,3596,114090,114089,1,114090,46.56,11.55
2021,2,Tierra Del Fuego,17,0,21335,6913,4580,476,889,1483,35693,8.59,12853,22504,6,14,316,35693,35404,289,35693,67.89,20.13
2021,2,Tucumán,32,97,40224,51648,23732,5022,109616,2680,233051,40.31,110429,48359,71683,1837,743,233051,233026,25,233051,54.93,13.61
2021,1,Buenos Aires,36939,31187,1108368,240520,163747,222061,2246313,10867,4060002,50.79,629679,2452056,821597,98806,57864,4060002,4054936,5066,4060002,69.11,23.0
2021,1,Capital Federal,135,244,159662,76753,56457,83255,1003041,126,1379673,68.29,159805,1145093,39980,5559,29236,1379673,1378283,1390,1379673,108.42,44.83
2021,1,Catamarca,71,0,7423,8455,10115,712,22996,2196,51968,39.97,26316,4409,18688,322,2233,51968,51967,1,51968,48.9,12.44
2021,1,Chaco,301,112,24357,22102,27556,14496,42462,8384,139770,33.63,43214,61251,25426,8004,1875,139770,139767,3,139770,43.14,11.53
2021,1,Chubut,106,109,86986,21401,15392,2844,1112,4390,132340,7.53,45501,40960,3444,23723,18712,132340,131515,825,132340,68.99,21.15
2021,1,Córdoba,93,2386,211799,135092,74659,71984,402191,12677,910881,36.17,260350,444695,134634,54137,17065,910881,910826,55,910881,78.59,24.06
2021,1,Corrientes,67,527,31544,26223,26169,9001,27641,5453,126625,25.99,49160,62876,3337,5949,5303,126625,126622,3,126625,42.66,11.23
2021,1,Entre Ríos,105,2911,67255,56060,42432,15774,54600,12826,251963,23.87,83688,118424,16846,20836,12169,251963,251950,13,251963,60.44,18.07
2021,1,Formosa,56,0,22409,7569,7916,1215,9579,1942,50686,20.98,20663,11412,2562,15669,380,50686,50686,0,50686,32.73,8.33
2021,1,Jujuy,49,175,23735,17293,40649,568,25609,2378,110456,26.78,32254,54324,17322,2677,3879,110456,110456,0,110456,55.63,14.23
2021,1,La Pampa,298,554,68200,7864,7611,2786,7368,2424,97105,10.73,8946,58711,15779,12369,1300,97105,96989,116,97105,81.78,26.94
2021,1,La Rioja,18,1,36749,5968,4604,215,5074,-1,52628,12.7,17363,34984,1,250,30,52628,52625,3,52628,49.81,13.26
2021,1,Mendoza,28,40,134386,11216,52533,4061,16615,44,218923,12.6,91844,69295,38619,18332,833,218923,218308,615,218923,39.15,10.93
2021,1,Misiones,51,524,40949,25503,27101,14050,32953,8256,149387,25.08,48292,82339,7064,4796,6896,149387,149387,0,149387,43.17,11.76
2021,1,Neuquén,116,327,56171,8443,5903,5677,50840,5758,133235,34.24,30223,70457,14171,17752,632,133235,132862,373,133235,66.84,19.9
2021,1,Río Negro,125,466,70011,4187,13045,3642,29589,20103,141168,21.92,48777,42192,17828,13994,18377,141168,140667,501,141168,60.88,18.72
2021,1,Salta,109,20,40785,68149,9164,8139,54889,6319,187574,27.32,54768,89187,31498,5669,6452,187574,187572,2,187574,53.93,13.06
2021,1,San Juan,25,194,60439,858,11494,340,276,4641,78267,6.91,40072,11589,6671,11482,8453,78267,78011,256,78267,39.06,9.95
2021,1,San Luis,58,0,11889,2926,4429,62913,22,36917,119154,21.59,8417,10678,28,63826,36205,119154,119006,148,119154,81.24,23.25
2021,1,Santa Cruz,50,0,30655,8334,6987,1337,647,-1945,46065,7.5,12347,23089,5975,4264,390,46065,45868,197,46065,41.65,12.39
2021,1,Santa Fe,518,891,201632,204458,91846,65476,236924,24382,826127,28.13,277012,421480,70976,39140,17519,826127,825990,137,826127,73.92,23.24
2021,1,Santiago Del Estero,123,909,33884,58464,8549,700,4868,4144,111641,11.58,26468,75849,570,5158,3596,111641,111640,1,111641,45.67,11.33
2021,1,Tierra Del Fuego,17,0,21379,1468,4317,486,919,11836,40422,8.73,12853,27247,6,0,316,40422,40133,289,40422,77.35,22.93
2021,1,Tucumán,29,97,42810,53416,25255,4188,103437,2680,231912,37.98,147199,12185,69954,1834,740,231912,231890,22,231912,54.82,13.58
2020,4,Buenos Aires,36939,31197,1109865,242243,214171,213588,2176242,9016,4033261,50.01,635651,2441248,804991,93444,57927,4033261,4028195,5066,4033261,68.98,22.9
2020,4,Capital Federal,135,244,160210,78123,60208,80269,1000073,268,1379530,67.33,163060,1142528,39890,4815,29237,1379530,1378140,1390,1379530,108.31,44.83
2020,4,Catamarca,71,0,8843,8740,11436,591,20406,2309,52396,37.65,26870,5115,17856,322,2233,52396,52395,1,52396,49.41,12.57
2020,4,Chaco,301,112,24782,22479,26802,15701,40949,7965,139091,32.45,44332,61200,23687,7997,1875,139091,139088,3,139091,43.03,11.5
2020,4,Chubut,106,109,88157,21824,12046,2818,1112,4402,130574,7.38,45703,39756,3040,23363,18712,130574,129749,825,130574,68.35,20.95
2020,4,Córdoba,119,2386,214963,135262,82221,70013,384169,13568,902701,35.12,267396,439322,125620,52827,17536,902701,902646,55,902701,78.08,23.9
2020,4,Corrientes,67,527,31900,26321,25687,9383,26789,4985,125659,25.45,50102,61495,3146,5626,5290,125659,125656,3,125659,42.43,11.17
2020,4,Entre Ríos,105,2911,65659,53556,40755,16600,53141,14654,247381,24.05,85683,113670,15653,20206,12169,247381,247368,13,247381,59.47,17.78
2020,4,Formosa,56,0,23540,7606,7181,1197,8946,1680,50206,19.7,21264,10789,2432,15341,380,50206,50206,0,50206,32.49,8.27
2020,4,Jujuy,49,182,23772,14379,44930,446,19282,2811,105851,25.21,32850,52815,15639,1077,3470,105851,105851,0,105851,53.46,13.67
2020,4,La Pampa,298,554,70184,8124,6562,2396,6257,2520,96895,9.88,9009,58945,15432,12194,1315,96895,96779,116,96895,81.77,26.94
2020,4,La Rioja,18,1,36906,6060,4633,181,4979,0,52778,12.53,17513,34984,1,250,30,52778,52775,3,52778,50.11,13.34
2020,4,Mendoza,28,40,146312,11172,40396,3378,11557,2570,215453,11.09,91842,68364,36083,18331,833,215453,214838,615,215453,38.63,10.78
2020,4,Misiones,51,524,39988,26078,26445,14810,32264,7001,147161,24.96,49462,79855,6589,4359,6896,147161,147161,0,147161,42.64,11.61
2020,4,Neuquén,116,327,56434,8478,5791,5493,50776,5720,133135,33.91,30468,70614,13732,17689,632,133135,132762,373,133135,67.0,19.94
2020,4,Río Negro,125,466,70305,4153,13131,3512,29372,20146,141210,21.64,48991,42022,17826,13994,18377,141210,140709,501,141210,61.09,18.79
2020,4,Salta,109,514,41443,68829,15188,8291,46697,6319,187390,25.32,56659,87817,30604,5858,6452,187390,187388,2,187390,54.04,13.09
2020,4,San Juan,25,194,61316,740,5126,332,275,4588,72596,6.41,40072,7004,6599,10468,8453,72596,72340,256,72596,36.32,9.25
2020,4,San Luis,58,0,14020,3490,2688,62239,22,36918,119435,21.25,8417,11767,27,63019,36205,119435,119287,148,119435,81.68,23.38
2020,4,Santa Cruz,47,0,27173,4382,6634,1033,647,758,40674,7.49,12347,19657,1041,4659,2970,40674,40477,197,40674,37.0,11.01
2020,4,Santa Fe,518,891,206372,203793,94246,65145,226246,23602,820813,27.29,287271,414746,62692,38712,17392,820813,820676,137,820813,73.58,23.14
2020,4,Santiago Del Estero,123,909,34518,57590,4666,411,4520,3932,106669,11.28,26812,70522,570,5169,3596,106669,106668,1,106669,43.75,10.86
2020,4,Tierra Del Fuego,17,0,21881,6119,3497,488,922,6690,39614,8.49,12853,26439,6,0,316,39614,39325,289,39614,76.27,22.61
2020,4,Tucumán,29,97,44095,54334,32155,4105,93594,2680,231089,36.44,149322,11150,68043,1834,740,231089,231067,22,231089,54.78,13.57
2020,3,Buenos Aires,37542,31514,1113823,234710,219772,194248,2085815,19853,3937277,48.38,653930,2384557,749087,94162,55541,3937277,3932211,5066,3937277,67.66,22.41
2020,3,Capital Federal,264,312,162222,85083,68753,78028,977766,247,1372675,63.81,170375,1129573,39417,3936,29374,1372675,1371285,1390,1372675,107.68,44.62
2020,3,Catamarca,63,0,8276,8768,11195,562,18886,2154,49904,36.54,26868,3690,16857,261,2228,49904,49903,1,49904,47.16,12.0
2020,3,Chaco,308,112,24675,21639,27546,13751,38729,7194,133954,30.8,45745,58825,20675,6706,2003,133954,133951,3,133954,41.54,11.1
2020,3,Chubut,158,109,87559,22114,12217,2818,1110,3942,130027,7.4,45761,39386,2897,23216,18767,130027,129202,825,130027,68.34,20.95
2020,3,Córdoba,168,3064,218599,124833,84236,63823,361021,11728,867472,33.51,276360,430771,102217,48368,9756,867472,867417,55,867472,75.22,23.03
2020,3,Corrientes,72,527,35190,23315,25308,8615,25344,5020,123391,23.85,50858,58681,2960,5513,5379,123391,123388,3,123391,41.75,10.99
2020,3,Entre Ríos,130,2911,66648,51478,40797,14377,49395,15759,241495,22.43,87892,106950,13954,20379,12320,241495,241482,13,241495,58.19,17.4
2020,3,Formosa,391,151,23163,7432,7125,991,8219,1737,49209,18.28,21790,10003,2000,15023,393,49209,49209,0,49209,31.91,8.12
2020,3,Jujuy,55,182,32131,10566,45198,293,15238,3065,106728,21.91,32611,57682,11112,952,4371,106728,106728,0,106728,54.04,13.82
2020,3,La Pampa,293,810,66695,7820,5577,2189,6322,4029,93735,10.7,9015,56845,14677,11893,1305,93735,93619,116,93735,79.26,26.12
2020,3,La Rioja,21,1,37105,5955,4660,124,4748,2,52616,12.19,17346,34984,1,250,35,52616,52613,3,52616,50.12,13.34
2020,3,Mendoza,58,40,141404,12123,42433,3448,8237,45,207788,10.19,91908,64672,32817,17523,868,207788,207173,615,207788,37.35,10.42
2020,3,Misiones,71,524,39005,24215,25942,13663,30987,8779,143186,24.14,50195,77989,2572,3445,8985,143186,143186,0,143186,41.6,11.33
2020,3,Neuquén,218,327,60463,6561,5975,5449,49439,803,129235,31.46,30222,70446,11043,16787,737,129235,128862,373,129235,65.24,19.42
2020,3,Río Negro,114,466,68986,3769,7096,3455,28488,19093,131467,21.08,49530,40001,10381,13187,18368,131467,130966,501,131467,57.05,17.55
2020,3,Salta,129,514,32780,64736,15990,7928,43773,14996,180846,25.26,58216,84128,25445,5764,7293,180846,180844,2,180846,52.32,12.67
2020,3,San Juan,48,194,65526,711,6529,41,128,4150,77327,6.03,40092,9223,5509,14023,8480,77327,77071,256,77327,38.79,9.88
2020,3,San Luis,105,0,12199,3351,2666,61319,8,36917,116565,20.85,8401,10077,6,61828,36253,116565,116417,148,116565,79.96,22.88
2020,3,Santa Cruz,66,0,26888,4015,6730,629,120,833,39281,6.65,12845,16098,1027,6938,2373,39281,39084,197,39281,35.95,10.7
2020,3,Santa Fe,568,1241,213353,199381,92095,58797,210562,27001,802998,25.69,295051,405807,45721,37112,19307,802998,802861,137,802998,72.12,22.68
2020,3,Santiago Del Estero,133,909,33287,57418,4658,292,3994,4801,105492,10.88,26419,70720,555,4185,3613,105492,105491,1,105492,43.38,10.76
2020,3,Tierra Del Fuego,11,0,22094,5414,3726,481,937,6992,39655,8.51,12854,26491,0,0,310,39655,39366,289,39655,76.81,22.77
2020,3,Tucumán,52,97,45913,54610,33126,3246,84195,2637,223876,34.84,149605,11752,59949,1808,762,223876,223854,22,223876,53.23,13.18
2020,2,Buenos Aires,37542,31606,1129236,241336,233132,188995,1894466,21233,3777546,45.66,661272,2244277,723072,91736,57189,3777546,3772480,5066,3777546,65.22,21.55
2020,2,Capital Federal,264,312,166474,94585,79858,80160,935481,687,1357821,60.48,178896,1106133,39482,3937,29373,1357821,1356431,1390,1357821,106.41,44.15
2020,2,Catamarca,63,0,8801,8690,10242,426,16578,3176,47976,34.93,26968,3641,14878,261,2228,47976,47975,1,47976,45.43,11.56
2020,2,Chaco,308,928,24350,21140,29044,12082,33311,6969,128132,27.95,46816,56017,17266,6452,1581,128132,128129,3,128132,39.83,10.65
2020,2,Chubut,158,109,69578,22188,10537,1473,614,3999,108656,7.61,45761,38279,1324,17678,5614,108656,107831,825,108656,57.34,17.58
2020,2,Córdoba,168,4383,219025,125932,89530,63216,325243,8971,836468,30.99,282858,415007,85818,44522,8263,836468,836413,55,836468,72.71,22.26
2020,2,Corrientes,72,527,34242,22845,25844,7898,22418,5020,118866,22.15,51248,55536,3144,3927,5011,118866,118863,3,118866,40.3,10.61
2020,2,Entre Ríos,130,3679,66758,50640,42090,12856,43391,14569,234113,20.45,89391,99423,13954,20042,11303,234113,234100,13,234113,56.54,16.9
2020,2,Formosa,391,151,23534,7109,6998,961,7475,1313,47932,16.87,21805,9353,1882,14723,169,47932,47932,0,47932,31.14,7.93
2020,2,Jujuy,55,182,30548,10519,26829,209,9417,16557,94316,15.86,32705,38938,5057,952,16664,94316,94316,0,94316,47.89,12.25
2020,2,La Pampa,293,810,71218,7531,3800,1657,3377,1123,89809,8.03,8551,54422,14232,11314,1290,89809,89693,116,89809,76.1,25.07
2020,2,La Rioja,21,1,37375,5661,4686,73,4336,2,52155,11.67,16885,34984,1,250,35,52155,52152,3,52155,49.84,13.27
2020,2,Mendoza,58,40,142253,12439,35274,3248,5422,2450,201184,9.27,91904,62941,29613,15924,802,201184,200569,615,201184,36.25,10.12
2020,2,Misiones,71,524,39867,23719,26445,12305,28763,8646,140340,22.56,50792,74497,2579,3319,9153,140340,140340,0,140340,40.89,11.14
2020,2,Neuquén,218,327,61171,6103,6625,5296,46432,0,126172,29.1,30256,67990,11037,15755,1134,126172,125799,373,126172,63.9,19.02
2020,2,Río Negro,114,466,70817,3335,7498,3246,26953,17057,129486,19.68,49756,39650,10382,11331,18367,129486,128985,501,129486,56.37,17.34
2020,2,Salta,129,514,41801,64463,16989,7741,39594,6531,177762,22.56,59502,81740,24289,5123,7108,177762,177760,2,177762,51.58,12.49
2020,2,San Juan,48,194,59113,917,4908,40,127,4430,69777,6.31,40092,8275,5509,7019,8882,69777,69521,256,69777,35.09,8.94
2020,2,San Luis,105,0,11439,3585,1934,60889,8,35992,113952,21.02,8401,8357,6,60935,36253,113952,113804,148,113952,78.41,22.44
2020,2,Santa Cruz,66,0,26938,4166,6541,546,119,493,38869,6.59,12845,16044,1027,6585,2368,38869,38672,197,38869,35.79,10.65
2020,2,Santa Fe,568,2061,213054,198772,96575,57236,189473,20193,777932,23.93,299974,381679,46698,30487,19094,777932,777795,137,777932,70.0,22.01
2020,2,Santiago Del Estero,133,1779,32557,57709,5178,247,3328,4516,105447,10.41,25917,72074,355,3038,4063,105447,105446,1,105447,43.47,10.79
2020,2,Tierra Del Fuego,11,0,22325,5186,3034,391,796,7446,39189,8.13,12854,26025,0,0,310,39189,38900,289,39189,76.37,22.64
2020,2,Tucumán,52,97,49028,54537,34184,2246,74377,2635,217156,32.7,150084,9833,55120,1357,762,217156,217134,22,217156,51.78,12.83
2020,1,Buenos Aires,38215,36802,1122034,236421,247977,205780,1802583,28935,3718747,45.18,673237,2210349,720688,85443,18334,3708051,3702985,5066,3708051,64.33,21.21
2020,1,Capital Federal,264,312,169651,102254,89665,85899,906009,0,1354054,58.71,184494,1097635,38898,3911,28556,1353494,1352104,1390,1353494,105.98,44.02
2020,1,Catamarca,63,0,8838,7543,9558,408,10299,2151,38860,29.13,21945,3146,12056,261,2227,39635,39634,1,39635,37.62,9.57
2020,1,Chaco,308,928,23291,19976,29851,10416,28539,6917,120226,25.94,46356,54144,11958,6239,1580,120277,120274,3,120277,37.48,10.02
2020,1,Chubut,158,109,69586,12957,7756,1240,614,4500,96920,7.12,45763,27287,1324,16885,5479,96738,95938,800,96738,51.27,15.72
2020,1,Córdoba,142,5128,217229,120188,95827,65733,296875,9802,810924,29.39,286168,406109,68512,41617,8693,811099,811044,55,811099,70.69,21.64
2020,1,Corrientes,72,527,33479,21382,26679,7351,19467,4780,113737,20.54,51126,53231,2172,2437,5004,113970,113967,3,113970,38.73,10.2
2020,1,Entre Ríos,130,4081,72280,47132,41125,11988,39794,13762,230292,19.03,90368,95434,13245,18737,14062,231846,231833,13,231846,56.12,16.78
2020,1,Formosa,1127,342,23761,6500,6564,964,6918,100,46276,15.7,21068,8887,1800,14510,169,46434,46434,0,46434,30.23,7.69
2020,1,Jujuy,55,182,33120,9979,26693,166,7349,16545,94089,14.14,32066,38938,3078,942,16641,91665,91665,0,91665,46.67,11.93
2020,1,La Pampa,293,811,72740,7199,3029,1342,2113,1618,89145,7.29,8553,53755,13821,11295,1802,89226,89110,116,89226,75.77,24.96
2020,1,La Rioja,21,1,37209,5158,4640,22,1294,0,48345,7.96,13076,34984,0,251,29,48340,48337,3,48340,46.35,12.34
2020,1,Mendoza,58,40,140410,12285,17489,2860,3818,0,176960,8.44,91955,50251,28059,12465,722,183452,182837,615,183452,33.14,9.25
2020,1,Misiones,71,524,36622,21271,26433,11581,26313,10885,133700,22.15,51458,69452,1220,460,10962,133552,133552,0,133552,39.02,10.63
2020,1,Neuquén,218,327,60152,5257,7123,5399,43738,0,122214,27.77,29305,65951,11031,14711,729,121727,121354,373,121727,61.85,18.41
2020,1,Río Negro,114,466,69154,2930,7857,3199,25488,17719,126927,19.06,47756,38479,10381,11222,18362,126200,125699,501,126200,55.12,16.95
2020,1,Salta,129,514,38537,63714,17991,8625,34744,6441,170695,21.43,60426,75593,23025,4125,7212,170381,170379,2,170381,49.6,12.01
2020,1,San Juan,48,194,59787,1594,1292,40,127,4779,67861,6.04,40092,6448,5508,7082,5101,64231,63975,256,64231,32.39,8.25
2020,1,San Luis,105,0,11322,4164,525,58258,5,36075,110454,20.99,8301,7612,5,58301,36333,110552,110404,148,110552,76.31,21.84
2020,1,Santa Cruz,67,11,27447,4993,5169,529,119,0,38335,6.42,12845,15766,1026,6817,2368,38822,38625,197,38822,35.97,10.7
2020,1,Santa Fe,696,2994,217553,196826,104560,48448,173823,17656,762556,22.42,302366,383673,35123,30488,19468,771118,770981,137,771118,69.52,21.86
2020,1,Santiago Del Estero,133,1779,33086,56884,3737,135,2799,4501,103054,10.0,24695,70424,200,2779,4657,102755,102754,1,102755,42.47,10.54
2020,1,Tierra Del Fuego,11,1,22976,5024,1834,196,518,7046,37606,7.41,12854,25632,0,0,308,38794,38505,289,38794,76.07,22.55
2020,1,Tucumán,52,97,49555,50383,31096,1730,67536,0,200449,32.25,143184,10494,44687,1355,347,200067,200045,22,200067,47.85,11.85
2019,4,Buenos Aires,33489,27537,1177446,262297,247106,452570,1465133,20676,3686254,30.77,720011,2191672,669194,87111,18266,3686254,3681120,5134,3686254,64.25,21.14
2019,4,Capital Federal,307,15,177098,110218,110852,205810,753805,0,1358105,44.2,196938,1093143,35534,3914,28576,1358105,1356695,1410,1358105,106.25,44.19
2019,4,Catamarca,63,0,9945,7619,9305,804,7477,3098,38311,24.88,22999,3318,9506,261,2227,38311,38310,1,38311,36.44,9.27
2019,4,Chaco,83,0,25899,18959,30902,13516,21556,6988,117903,23.37,48661,53602,8831,5229,1580,117903,117900,3,117903,36.84,9.85
2019,4,Chubut,158,4,69405,12945,7615,1240,614,4121,96102,6.99,47045,26977,1324,15267,5489,96102,95292,810,96102,51.15,15.68
2019,4,Córdoba,142,0,232781,118232,109330,114111,221742,10350,806688,26.16,296872,410038,53335,37750,8693,806688,806633,55,806688,70.48,21.58
2019,4,Corrientes,72,0,35055,20620,27367,9981,15744,4995,113834,19.26,52525,51845,2002,2458,5004,113834,113831,3,113834,38.77,10.21
2019,4,Entre Ríos,47,0,88203,44511,42962,18976,30153,14178,239030,17.01,92981,99206,12875,18561,15407,239030,239017,13,239030,57.99,17.34
2019,4,Formosa,1127,191,24606,6319,6788,1766,5671,243,46711,14.53,21567,8684,1760,14531,169,46711,46711,0,46711,30.47,7.76
2019,4,Jujuy,55,0,32920,9632,26764,102,5286,14122,88881,12.96,32949,37604,873,814,16641,88881,88881,0,88881,45.38,11.6
2019,4,La Pampa,293,313,76747,6900,1951,1287,1342,1566,90399,6.53,15457,56854,4942,11341,1805,90399,90280,119,90399,76.92,25.34
2019,4,La Rioja,21,0,37846,5045,4763,22,1305,0,49002,8.0,13738,34984,0,251,29,49002,48999,3,49002,47.14,12.55
2019,4,Mendoza,746,9,145139,12955,15237,2165,2628,6901,185780,7.79,96678,49711,24989,13672,730,185780,185157,623,185780,33.65,9.39
2019,4,Misiones,71,0,39664,20840,27305,15626,20799,11508,135813,20.32,53116,69676,847,441,11733,135813,135813,0,135813,39.79,10.84
2019,4,Neuquén,218,1,57370,4439,7357,12059,35001,0,116445,26.02,29826,60970,10549,14246,854,116445,116069,376,116445,59.36,17.67
2019,4,Río Negro,114,0,71847,2797,8558,6968,19837,17019,127140,17.18,49747,37933,9658,11437,18365,127140,126636,504,127140,55.71,17.13
2019,4,Salta,149,1,42159,67656,15369,14170,25821,7120,172445,19.08,63272,76062,21865,3040,8206,172445,172443,2,172445,50.35,12.2
2019,4,San Juan,48,1,60626,1594,1292,40,127,1246,64974,6.04,41360,6338,4931,7241,5104,64974,64715,259,64974,32.85,8.37
2019,4,San Luis,105,0,11901,4164,525,55216,3,36287,108201,20.69,8569,8027,6,55266,36333,108201,108053,148,108201,74.92,21.44
2019,4,Santa Cruz,67,0,32368,4346,2224,7,8,350,39370,5.21,13264,15899,1036,6800,2371,39370,39170,200,39370,36.71,10.92
2019,4,Santa Fe,698,0,230234,190664,113527,70998,135576,27472,769169,20.55,312072,382254,27464,26978,20401,769169,769019,150,769169,69.48,21.85
2019,4,Santiago Del Estero,133,908,34911,56309,3756,105,2449,5017,103588,9.79,24682,71239,200,2810,4657,103588,103587,1,103588,42.92,10.65
2019,4,Tierra Del Fuego,11,0,23593,5050,1848,139,1962,7789,40392,7.27,13261,26821,0,0,310,40392,40101,291,40392,79.7,23.63
2019,4,Tucumán,55,0,54544,52017,28916,6405,56707,0,198644,29.87,146985,11012,39574,725,348,198644,198621,23,198644,47.65,11.8
2019,3,Buenos Aires,238920,44648,1432722,222812,260506,483572,1246209,42294,3971683,25.68,1277249,2144956,425386,85572,27070,3960233,3950114,10119,3960233,69.36,22.76
2019,3,Capital Federal,104,368,269704,120924,138011,258591,655108,0,1442810,38.71,300288,1080973,24900,3895,31155,1441211,1437734,3477,1441211,112.65,46.9
2019,3,Catamarca,34,43,14449,9285,6333,72,15,2151,32382,9.29,24349,5543,13,244,2251,32400,32391,9,32400,30.88,7.86
2019,3,Chaco,69,1216,32764,28198,13336,12987,16740,6917,112227,19.99,50416,49156,8063,5224,1592,114451,114438,13,114451,35.85,9.58
2019,3,Chubut,74,840,62680,13033,7171,1240,614,4500,90152,6.97,37298,27090,1917,15149,7551,89005,87481,1524,89005,47.57,14.58
2019,3,Córdoba,83,5824,240151,106651,118486,146247,157546,7353,782341,23.19,307780,399231,30064,37277,8701,783053,782946,107,783053,68.59,21.0
2019,3,Corrientes,10,597,42231,29628,10348,10388,12674,4780,110656,16.7,53344,50230,1888,2458,4839,112759,112749,10,112759,38.49,10.13
2019,3,Entre Ríos,19,4446,99656,56161,17064,21216,22645,15107,236314,14.7,94947,96305,12888,18530,15432,238102,238057,45,238102,57.9,17.31
2019,3,Formosa,1110,349,24943,6049,7117,2262,4443,100,46373,13.22,21777,8359,1476,14292,162,46066,46066,0,46066,30.11,7.66
2019,3,Jujuy,27,885,31722,9240,26835,56,3671,16545,88981,11.97,33110,35742,274,812,16638,86576,86575,1,86576,44.32,11.33
2019,3,La Pampa,237,3289,75849,5922,1611,1359,941,1618,90826,5.72,19469,52941,4994,11462,1962,90828,90559,269,90828,77.45,25.52
2019,3,La Rioja,9,10,38657,4786,4887,22,1307,0,49678,8.0,14390,34984,11,251,41,49677,49659,18,49677,47.94,12.76
2019,3,Mendoza,21,1269,206821,2958,10093,1263,349,0,222774,6.11,148640,54312,6865,12975,1545,224337,223015,1322,224337,40.74,11.37
2019,3,Misiones,47,1928,43530,29375,11256,16107,16650,12206,131099,17.93,54493,65872,829,419,12270,133883,133883,0,133883,39.33,10.71
2019,3,Neuquén,45,2258,62909,4586,9597,16923,28458,122,124898,23.75,43347,60484,5560,13512,2518,125421,123435,1986,125421,64.14,19.09
2019,3,Río Negro,47,1234,87435,2348,9779,10176,15505,17719,144243,15.98,67478,37425,9739,10806,18847,144295,143391,904,144295,63.42,19.51
2019,3,Salta,49,900,43160,62230,14309,11418,12357,7515,151938,14.75,65799,74329,733,1580,9394,151835,151834,1,151835,44.48,10.77
2019,3,San Juan,22,171,68315,2245,1267,41,128,4779,76968,6.04,51670,7425,1227,7241,5535,73098,72535,563,73098,37.06,9.44
2019,3,San Luis,57,100,18643,5113,467,62242,5,36075,122702,19.74,13037,10561,350,62286,36466,122700,122409,291,122700,85.23,24.39
2019,3,Santa Cruz,28,84,31612,4472,1203,27,4,0,37430,5.02,10663,17056,969,6544,2738,37970,37642,328,37970,35.63,10.6
2019,3,Santa Fe,640,8184,242454,193286,107068,84325,97082,19537,752576,18.17,319396,377171,18690,24269,21408,760934,760706,228,760934,68.87,21.66
2019,3,Santiago Del Estero,39,1832,35554,55172,3612,86,1836,34501,132632,9.39,24556,71198,219,2759,34400,133132,133130,2,133132,55.3,13.73
2019,3,Tierra Del Fuego,6,14,32133,4692,1756,82,226,9648,48557,6.69,19790,26659,651,0,1487,48587,48043,544,48587,96.46,28.6
2019,3,Tucumán,16,110,71043,47693,24354,843,20385,0,164444,19.32,150918,12089,116,684,324,164131,164099,32,164131,39.49,9.78
2019,2,Buenos Aires,199768,46852,1436259,217785,438663,502275,985767,43438,3870807,22.48,1284658,2079900,382971,75240,32929,3855698,3845594,10104,3855698,67.85,22.22
2019,2,Capital Federal,74,1027,281370,124087,239691,296155,475991,0,1418395,30.35,309937,1061358,36082,3962,4281,1415620,1412177,3443,1415620,110.55,46.09
2019,2,Catamarca,34,43,16631,8670,6049,34,10,2151,33622,8.81,25682,5543,13,146,2251,33635,33626,9,33635,32.13,8.17
2019,2,Chaco,69,1383,38488,26431,16789,15348,9904,1492,109904,16.01,50765,47448,4203,4727,1591,108734,108721,13,108734,34.14,9.13
2019,2,Chubut,66,3952,69032,10049,1495,74,165,4500,89333,6.05,37313,26338,1917,14443,7545,87556,86038,1518,87556,46.99,14.4
2019,2,Córdoba,81,8165,248427,100512,157458,170159,76053,8938,769793,18.43,314768,388254,23023,33847,15236,775128,775023,105,775128,68.07,20.84
2019,2,Corrientes,10,3012,40424,27774,13114,11928,7119,6080,109461,13.83,53835,47431,1701,2444,6138,111549,111539,10,111549,38.16,10.05
2019,2,Entre Ríos,18,5905,100687,52316,23196,24221,10664,17206,234213,12.19,97081,91081,12764,17369,17529,235824,235780,44,235824,57.48,17.19
2019,2,Formosa,1110,349,26512,5399,8384,2639,2258,100,46751,10.84,21916,8686,1382,14292,162,46438,46438,0,46438,30.42,7.74
2019,2,Jujuy,27,940,26233,8441,26700,27,2600,21765,86733,12.07,33022,30742,274,812,21857,86707,86706,1,86707,44.51,11.38
2019,2,La Pampa,236,3289,75406,5191,1366,1445,629,2661,90223,5.49,19471,52101,4840,10789,3004,90205,89937,268,90205,77.08,25.4
2019,2,La Rioja,9,11,39819,4297,4857,13,1298,0,50304,7.89,15014,34984,11,251,41,50301,50283,18,50301,48.7,12.97
2019,2,Mendoza,20,2522,205165,2971,10092,1256,234,0,222260,6.03,148673,54027,6865,12748,1544,223857,222535,1322,223857,40.75,11.37
2019,2,Misiones,47,2226,45769,27385,15408,18882,8129,12206,130052,14.5,55373,64272,543,421,12269,132878,132878,0,132878,39.15,10.66
2019,2,Neuquén,302,3038,61776,4688,17318,21210,14132,422,122886,17.24,43420,59021,4983,12792,2737,122953,120954,1999,122953,63.08,18.78
2019,2,Río Negro,384,1354,86366,2201,10291,12407,6907,18519,138429,11.63,67841,36527,4037,10485,19657,138547,137632,915,138547,61.09,18.79
2019,2,Salta,49,974,59638,36923,16961,14059,6461,7585,142650,12.55,68827,62343,725,1210,9463,142568,142567,1,142568,41.89,10.15
2019,2,San Juan,22,213,60913,2177,785,7,4,6119,70240,6.12,51680,7425,1174,2870,6876,70025,69461,564,70025,35.6,9.07
2019,2,San Luis,57,102,16575,4964,467,57236,5,37977,117383,19.88,11130,10298,347,57242,38368,117385,117094,291,117385,81.79,23.41
2019,2,Santa Cruz,25,84,24861,3806,1202,28,4,0,30010,6.01,10665,10257,379,6514,2735,30550,30225,325,30550,28.85,8.58
2019,2,Santa Fe,321,8427,300124,125176,129741,100131,49865,22323,736108,15.07,325420,355140,18236,21980,22708,743484,743258,226,743484,67.42,21.2
2019,2,Santiago Del Estero,39,1832,63268,21362,3741,108,1205,34501,126056,7.1,24393,64783,219,2759,34600,126754,126752,2,126754,52.79,13.1
2019,2,Tierra Del Fuego,6,123,41824,4241,1573,96,32,0,47895,6.34,19790,25527,651,0,1486,47454,46910,544,47454,94.8,28.11
2019,2,Tucumán,16,157,78891,44296,24291,628,18394,0,166673,18.53,153121,12089,116,684,321,166331,166299,32,166331,40.14,9.94
2019,1,Buenos Aires,162513,72296,1429964,202511,576428,576859,705769,6369,3732709,19.64,1304507,2020730,336362,64867,20201,3746667,3736563,10104,3746667,66.24,21.64
2019,1,Capital Federal,74,7417,283787,131007,330122,365713,283463,0,1401583,24.72,328246,1030814,32281,3978,4281,1399600,1396157,3443,1399600,109.2,45.58
2019,1,Catamarca,34,1708,18761,6443,5606,29,7,2151,34739,7.96,26912,4443,16,0,2251,33622,33613,9,33622,32.19,8.19
2019,1,Chaco,69,3801,38719,25632,18965,12393,6368,1035,106982,13.44,53409,43555,1951,3628,1134,103677,103664,13,103677,32.64,8.72
2019,1,Chubut,66,3938,71077,6571,787,74,165,0,82678,5.89,37302,23065,1923,14443,3045,79778,78260,1518,79778,43.0,13.18
2019,1,Córdoba,81,20403,242769,96997,200681,127965,50716,6806,746418,15.73,323272,363959,19902,24615,12367,744115,744010,105,744115,65.52,20.06
2019,1,Corrientes,10,6470,38402,26562,15498,9688,5029,0,101659,12.05,55842,43444,1615,1528,58,102487,102477,10,102487,35.13,9.25
2019,1,Entre Ríos,18,9217,107013,50068,28957,18146,7619,12142,233180,10.66,100999,90253,12723,16231,12241,232447,232403,44,232447,56.79,16.98
2019,1,Formosa,1110,3023,23085,5301,9027,2099,1654,0,45299,9.83,22570,7878,940,13761,62,45211,45211,0,45211,29.68,7.55
2019,1,Jujuy,27,2817,30727,7811,4021,30,1141,37162,83736,8.56,33248,12484,153,640,43622,90147,90146,1,90147,46.41,11.87
2019,1,La Pampa,236,8327,70538,4466,1061,1354,405,698,87085,5.06,18832,57373,2891,9023,1041,89160,88892,268,89160,76.35,25.16
2019,1,La Rioja,9,1169,40285,4088,5216,17,869,0,51653,7.09,16367,34984,12,252,41,51656,51638,18,51656,50.18,13.36
2019,1,Mendoza,20,1786,205383,2837,5702,111,140,0,215979,5.74,148524,40205,5662,10363,1544,206298,204976,1322,206298,37.66,10.51
2019,1,Misiones,47,5946,45266,25890,19111,16552,5167,7654,125633,12.51,54898,59214,465,426,7717,122720,122720,0,122720,36.26,9.88
2019,1,Neuquén,1328,3055,52360,1781,21452,17135,11026,6105,114242,15.88,40747,55634,3114,12510,2372,114377,112321,2056,114377,58.88,17.53
2019,1,Río Negro,384,1583,84845,2037,13615,9567,5076,3719,120826,10.49,68377,34124,3994,9736,4857,121088,120173,915,121088,53.57,16.48
2019,1,Salta,49,4232,59244,36473,22910,10861,2242,1,136012,10.38,74426,57933,647,1135,1879,136020,136019,1,136020,40.1,9.71
2019,1,San Juan,22,229,62380,266,520,3,2,560,63982,5.84,51660,5838,808,2932,1207,62445,61881,564,62445,31.83,8.11
2019,1,San Luis,57,120,21380,53214,345,6,2,23577,98701,8.71,11108,7784,378,53097,23968,96335,96044,291,96335,67.34,19.27
2019,1,Santa Cruz,25,128,21990,2731,702,26,4,0,25606,5.78,10659,4615,382,6514,2735,24905,24580,325,24905,23.67,7.04
2019,1,Santa Fe,333,29350,296798,122959,153212,74575,36502,18591,732320,12.99,340038,340344,15621,23215,17860,737078,736851,227,737078,66.97,21.06
2019,1,Santiago Del Estero,39,3372,62895,20691,3959,85,494,0,91535,6.42,25337,61547,23,2847,99,89853,89851,2,89853,37.52,9.31
2019,1,Tierra Del Fuego,6,131,38851,3623,641,80,29,0,43361,6.34,19789,23549,1623,0,1486,46447,45903,544,46447,93.38,27.68
2019,1,Tucumán,16,5188,82240,42877,26210,847,14839,0,172217,16.57,159215,11670,118,678,321,172002,171970,32,172002,41.63,10.31
2018,4,Buenos Aires,134673,73761,1422463,194426,577679,949093,265386,19125,3636606,16.93,1305576,1949637,296102,65477,19814,3636606,3626502,10104,3636606,64.6,21.06
2018,4,Capital Federal,74,7388,283281,143309,330496,437662,186810,0,1389020,22.94,328253,1019490,33042,3978,4257,1389020,1385577,3443,1389020,108.27,45.25
2018,4,Catamarca,34,1669,17955,6425,5461,29,7,2003,33583,8.04,26912,4443,16,0,2212,33583,33574,9,33583,32.23,8.2
2018,4,Chaco,69,3405,36437,25633,18965,12393,6368,0,103270,13.49,53409,43555,1940,3236,1130,103270,103257,13,103270,32.59,8.71
2018,4,Chubut,66,3917,66061,6215,531,623,165,1144,78722,6.09,37215,23065,952,14443,3047,78722,77204,1518,78722,42.61,13.06
2018,4,Córdoba,81,24102,228475,97277,201639,128053,48809,8903,737339,15.81,328854,355716,17675,21851,13243,737339,737234,105,737339,65.09,19.93
2018,4,Corrientes,10,6438,37376,26562,15498,9688,5029,0,100601,12.14,55842,42418,796,1515,30,100601,100591,10,100601,34.57,9.1
2018,4,Entre Ríos,18,8769,94780,50027,29002,18146,7612,13693,222047,11.02,101168,86198,4853,15472,14356,222047,222003,44,222047,54.37,16.26
2018,4,Formosa,1110,3074,22962,5285,9027,2092,1654,0,45204,9.82,22619,7880,887,13761,57,45204,45204,0,45204,29.74,7.57
2018,4,Jujuy,27,2803,30727,7811,4021,30,1141,43573,90133,8.56,33248,12484,153,640,43608,90133,90132,1,90133,46.53,11.9
2018,4,La Pampa,241,7727,70508,3661,978,1328,270,923,85636,4.32,18832,55337,2685,7772,1010,85636,85368,268,85636,73.49,24.22
2018,4,La Rioja,9,1164,40285,4088,5216,17,869,3,51651,7.09,16367,34984,12,252,36,51651,51633,18,51651,50.35,13.4
2018,4,Mendoza,20,1463,197450,2494,4726,19,132,0,206304,5.75,148524,40205,5665,10363,1547,206304,204982,1322,206304,37.76,10.54
2018,4,Misiones,47,5981,43267,26019,19226,16566,5167,0,116273,12.5,55500,53673,465,426,6209,116273,116273,0,116273,34.45,9.38
2018,4,Neuquén,1328,3044,52313,1781,21452,17135,11025,6287,114365,15.89,40747,55634,3115,12425,2444,114365,112309,2056,114365,59.07,17.58
2018,4,Río Negro,384,1225,83412,643,13440,9569,5070,3094,116837,10.49,68377,34292,1299,8037,4832,116837,115922,915,116837,51.86,15.95
2018,4,Salta,49,3659,58492,36365,22910,10861,2242,0,134578,10.46,74295,57539,638,253,1853,134578,134577,1,134578,39.8,9.64
2018,4,San Juan,22,1465,59811,180,312,1,1,606,62398,5.72,51660,5838,806,2883,1211,62398,61834,564,62398,31.9,8.13
2018,4,San Luis,57,109,19164,53183,119,62,2,23635,96331,8.82,11108,7784,378,53097,23964,96331,96040,291,96331,67.55,19.33
2018,4,Santa Cruz,25,115,23107,779,206,1,4,531,24768,5.12,10659,4615,382,6378,2734,24768,24443,325,24768,23.69,7.05
2018,4,Santa Fe,335,31397,276301,121009,152039,74432,36427,28450,720390,13.18,335519,322782,14387,18705,28997,720390,720161,229,720390,65.59,20.62
2018,4,Santiago Del Estero,39,3250,61347,20127,3686,77,483,326,89335,6.31,25339,61243,23,2649,81,89335,89333,2,89335,37.4,9.28
2018,4,Tierra Del Fuego,6,27,29919,6323,9894,24,67,0,46260,7.44,19789,23349,1623,0,1499,46260,45716,544,46260,93.59,27.75
2018,4,Tucumán,16,5244,82089,42766,26111,847,14839,92,172004,16.58,159215,11670,119,686,314,172004,171972,32,172004,41.76,10.34
2018,3,Buenos Aires,991,80459,1445733,190805,636090,897964,237248,120464,3609754,16.78,1435856,1929273,156382,62318,26448,3610277,3599714,10563,3610277,64.44,20.96
2018,3,Capital Federal,73,8493,287919,147253,370677,415020,165055,0,1394490,21.64,334353,1009252,35694,3872,9319,1392490,1385804,6686,1392490,108.45,45.38
2018,3,Catamarca,34,1994,18475,6358,5320,34,7,2151,34373,7.81,27553,4443,15,1,2214,34226,34215,11,34226,32.92,8.37
2018,3,Chaco,70,3503,38729,24916,20335,11085,5667,1035,105340,12.89,53927,42359,1990,2628,1129,102033,102021,12,102033,32.28,8.63
2018,3,Chubut,67,3951,91096,6162,531,623,164,0,102594,6.08,58887,23065,1239,13817,6728,103736,101310,2426,103736,56.39,17.29
2018,3,Córdoba,81,24767,224471,96372,221984,109333,39854,6490,723352,14.82,337620,342401,15785,19213,10839,725858,725764,94,725858,64.24,19.67
2018,3,Corrientes,11,6754,38364,24953,16601,8357,4419,0,99459,11.49,56444,41300,212,1468,32,99456,99445,11,99456,34.25,9.02
2018,3,Entre Ríos,18,9048,96095,45651,31353,15111,6786,0,204062,10.52,103318,83714,2403,15093,80,204608,204560,48,204608,50.22,15.02
2018,3,Formosa,1110,3365,22624,5259,9336,1729,1434,0,44857,9.32,22777,7589,817,13625,57,44865,44865,0,44865,29.58,7.53
2018,3,Jujuy,345,3020,29048,7756,4066,39,623,0,44897,7.67,33363,10856,32,641,43,44935,44934,1,44935,23.26,5.95
2018,3,La Pampa,242,8417,68507,3153,920,1189,216,698,83342,4.28,12415,54574,8437,7011,987,83424,83180,244,83424,71.75,23.64
2018,3,La Rioja,9,1291,40647,4138,5425,20,339,0,51869,6.16,16587,34984,13,253,35,51872,51855,17,51872,50.73,13.51
2018,3,Mendoza,20,1525,199297,2476,4727,27,129,0,208201,5.79,151033,40205,5744,8195,1852,207029,205545,1484,207029,37.99,10.6
2018,3,Misiones,48,5749,39617,24747,21212,14674,4547,0,110594,12.49,56290,50793,512,391,56,108042,108042,0,108042,32.1,8.74
2018,3,Neuquén,1396,2244,55822,1647,23785,15218,9718,6105,115935,14.67,46602,54129,998,12277,2712,116718,114713,2005,116718,60.49,18.01
2018,3,Río Negro,409,5221,75929,512,14912,8470,4332,3719,113504,10.06,68590,33474,1252,5051,5125,113492,112433,1059,113492,50.54,15.55
2018,3,Salta,116,3721,61795,32782,25582,9224,502,0,133722,9.27,76600,53980,678,234,1391,132883,132882,1,132883,39.43,9.55
2018,3,San Juan,22,1326,62525,180,312,3,1,0,64369,5.74,54025,5838,826,2744,1048,64481,63823,658,64481,33.05,8.42
2018,3,San Luis,57,109,19170,52940,119,63,2,1902,74362,8.81,11096,7784,368,52859,2314,74421,74121,300,74421,52.35,14.98
2018,3,Santa Cruz,26,116,32815,778,206,1,3,0,33945,5.37,18606,4574,585,6238,3996,33999,33565,434,33999,32.73,9.74
2018,3,Santa Fe,467,36786,269211,115907,162545,62479,31266,13911,692572,12.36,339126,312866,11749,16337,15022,695100,694883,217,695100,63.41,19.94
2018,3,Santiago Del Estero,41,2550,60260,19116,3806,64,265,0,86102,5.78,25805,58789,23,1662,81,86360,86358,2,86360,36.25,9.0
2018,3,Tierra Del Fuego,6,187,41569,2270,231,24,13,0,44300,5.99,19365,22649,1502,1,2047,45564,45056,508,45564,92.77,27.51
2018,3,Tucumán,16,5993,81559,43282,27062,941,12187,0,171040,15.26,161209,9280,110,252,315,171166,171135,31,171166,41.68,10.33
2018,2,Buenos Aires,1009,81354,1459443,295457,816056,536049,199589,113357,3502314,14.68,1450203,1807868,143626,71256,27746,3500699,3490134,10565,3500699,62.78,20.37
2018,2,Capital Federal,73,9234,290291,219166,445345,264805,142253,0,1371167,18.94,342431,977916,35610,3908,9321,1369186,1362498,6688,1369186,106.53,44.63
2018,2,Catamarca,34,2414,14624,6112,4347,36,6,6500,34073,7.69,27444,4415,15,1,2214,34089,34078,11,34089,32.86,8.36
2018,2,Chaco,70,2968,34167,24282,21887,9251,4630,1035,98290,12.5,54134,40750,562,1946,1129,98521,98509,12,98521,31.25,8.35
2018,2,Chubut,67,4471,85598,5369,4,5,9,5010,100533,5.33,58935,19591,1239,14070,6729,100564,98137,2427,100564,54.9,16.83
2018,2,Córdoba,81,21779,219630,102596,244291,78852,34950,8110,710289,13.88,345141,327636,13832,16355,10109,713073,712979,94,713073,63.27,19.37
2018,2,Corrientes,11,7047,38268,24066,17926,6780,3862,0,97960,10.88,56541,39715,201,1468,32,97957,97946,11,97957,33.81,8.9
2018,2,Entre Ríos,18,8179,94459,44570,34281,12012,5920,0,199439,10.19,104811,80376,2405,12313,80,199985,199937,48,199985,49.2,14.71
2018,2,Formosa,1110,3568,22409,5176,9727,1313,1243,0,44546,8.97,23543,7311,18,13625,57,44554,44554,0,44554,29.43,7.49
2018,2,Jujuy,345,3320,29319,8083,3977,44,7,0,45095,6.29,33571,10856,23,640,43,45133,45132,1,45133,23.43,5.99
2018,2,La Pampa,244,8797,68083,2409,965,969,179,698,82344,4.1,12416,53587,8420,7011,987,82421,82177,244,82421,71.04,23.41
2018,2,La Rioja,9,1384,40679,4198,5640,20,15,0,51945,5.59,16663,34984,13,253,35,51948,51931,17,51948,50.98,13.57
2018,2,Mendoza,20,1658,164596,515,266,17,72,33788,200932,5.88,152938,36872,3084,6206,1852,200952,199468,1484,200952,36.97,10.32
2018,2,Misiones,48,6092,39489,23569,23747,11888,3866,0,108699,11.76,57265,47923,512,391,56,106147,106147,0,106147,31.63,8.62
2018,2,Neuquén,1396,2408,56035,1314,26417,12442,8551,6105,114668,13.37,46633,52855,998,12649,2713,115848,113842,2006,115848,60.24,17.93
2018,2,Río Negro,409,5298,75056,523,16480,6663,3725,3975,112129,9.51,68667,32795,1252,4396,5125,112235,111176,1059,112235,50.15,15.43
2018,2,Salta,116,3990,61763,33285,28431,7239,182,0,135006,8.93,78386,53478,678,234,1391,134167,134166,1,134167,39.94,9.67
2018,2,San Juan,22,1378,57591,11,0,3,0,5068,64073,5.85,54080,5068,826,3079,1048,64101,63443,658,64101,32.95,8.39
2018,2,San Luis,57,101,11992,11,0,7,2,9284,21454,5.9,11104,7666,368,16,2314,21468,21168,300,21468,15.15,4.34
2018,2,Santa Cruz,26,120,28600,655,100,1,3,4267,33772,5.19,18615,4474,585,6734,3997,34405,33970,435,34405,33.33,9.92
2018,2,Santa Fe,744,34267,262603,112143,175540,50525,26512,22257,684591,11.75,337934,304349,11354,15801,15114,684552,684243,309,684552,62.57,19.68
2018,2,Santiago Del Estero,41,2717,41362,18721,3278,31,31,17589,83770,5.91,26074,55935,23,1662,81,83775,83773,2,83775,35.26,8.75
2018,2,Tierra Del Fuego,6,188,40912,2217,75,0,0,107,43505,5.94,19372,22756,531,1,2047,44707,44199,508,44707,91.61,27.16
2018,2,Tucumán,16,6735,79899,44968,27059,1084,8784,1305,169850,13.51,160315,8965,110,252,315,169957,169926,31,169957,41.51,10.28
2018,1,Buenos Aires,1514,74766,1445752,292732,886678,480237,184203,105818,3471700,14.2,1452061,1793884,133928,64379,31194,3475446,3464882,10564,3475446,62.63,20.28
2018,1,Capital Federal,89,10039,292566,222737,487826,227953,127384,0,1368594,17.75,349995,968483,35535,3164,9393,1366570,1359882,6688,1366570,106.24,44.56
2018,1,Catamarca,34,2896,14770,6145,3539,41,4,6500,33929,8.2,27300,4415,15,1,2214,33945,33934,11,33945,32.79,8.34
2018,1,Chaco,70,3261,32516,24488,23296,8219,3897,1035,96782,12.44,54879,40157,383,388,1130,96937,96925,12,96937,30.83,8.24
2018,1,Chubut,67,4314,83161,5358,4,5,9,5010,97928,5.42,56375,19591,1194,14070,6729,97959,95532,2427,97959,53.72,16.47
2018,1,Córdoba,281,23922,222815,104300,266259,57137,29228,10049,713991,12.79,349342,326894,13178,13237,11275,713926,713825,101,713926,63.52,19.45
2018,1,Corrientes,11,5005,37152,24038,19068,5890,3256,0,94420,11.12,56937,35225,888,1334,33,94417,94406,11,94417,32.66,8.6
2018,1,Entre Ríos,18,8861,90080,45599,37401,9818,5071,0,196848,9.88,106998,75751,3789,10776,80,197394,197346,48,197394,48.68,14.56
2018,1,Formosa,1110,3803,10092,5117,10061,1091,1046,0,32320,11.06,23556,7095,17,1603,57,32328,32328,0,32328,21.4,5.45
2018,1,Jujuy,345,4807,27219,8044,3925,49,4,0,44393,6.74,33856,10456,23,28,43,44406,44405,1,44406,23.12,5.91
2018,1,La Pampa,245,8119,67104,1616,1076,614,98,3503,82375,4.0,10807,51389,8386,10556,1926,83064,82668,396,83064,71.75,23.64
2018,1,La Rioja,9,1485,40680,4217,5831,19,1,0,52242,5.89,16960,34984,13,253,35,52245,52228,17,52245,51.44,13.69
2018,1,Mendoza,20,1662,164599,501,266,19,72,33788,200927,5.88,152931,36872,3086,6206,1852,200947,199463,1484,200947,37.07,10.35
2018,1,Misiones,48,4700,35820,23291,26223,10241,3219,0,103542,12.08,56311,46880,328,5,56,103580,103580,0,103580,30.96,8.43
2018,1,Neuquén,1396,2367,59468,1311,29012,9709,7378,6105,116746,11.96,46714,55072,1000,12404,2713,117903,115897,2006,117903,61.52,18.31
2018,1,Río Negro,409,5333,74894,530,17997,4972,3129,3975,111239,8.98,68769,31712,1251,4259,5128,111119,110057,1062,111119,49.82,15.32
2018,1,Salta,116,4459,60334,33088,30771,5145,88,0,134001,9.19,79936,51534,118,204,1391,133183,133182,1,133183,39.78,9.63
2018,1,San Juan,22,1058,57078,11,0,3,0,5068,63240,5.85,54080,5068,826,2246,1048,63268,62610,658,63268,32.61,8.31
2018,1,San Luis,57,101,11920,11,0,7,2,9284,21382,5.89,11104,7594,368,16,2314,21396,21096,300,21396,15.15,4.34
2018,1,Santa Cruz,26,120,28600,655,100,1,3,4267,33772,5.19,18615,4474,1799,6734,2783,34405,33970,435,34405,33.55,9.98
2018,1,Santa Fe,1359,33639,262008,108576,188900,39589,22801,23181,680053,11.17,341997,300421,10674,11636,15298,680026,679717,309,680026,62.28,19.58
2018,1,Santiago Del Estero,41,2910,41298,18914,3449,33,2,17589,84236,6.25,26788,54594,23,1432,81,82918,82916,2,82918,34.99,8.68
2018,1,Tierra Del Fuego,6,307,33987,2,0,0,0,107,34409,5.77,19372,9663,531,1,2047,31614,31106,508,31614,65.2,19.33
2018,1,Tucumán,16,7472,78811,45675,26405,1218,7082,1305,167984,9.36,158611,8921,107,368,50,168057,168026,31,168057,41.18,10.2
2017,4,Buenos Aires,3865,55046,1551194,264645,712513,335140,151747,114182,3188332,12.97,1241172,1718013,131181,60082,31448,3181896,3171206,10690,3181896,57.61,18.61
2017,4,Capital Federal,314,31411,517018,284040,458120,178396,114939,0,1584238,15.2,571363,961688,36277,3119,9877,1582324,1575418,6906,1582324,122.9,51.62
2017,4,Catamarca,34,3182,15315,5904,2927,43,2,2151,29558,7.78,27083,263,11,1,2200,29558,29548,10,29558,28.62,7.28
2017,4,Chaco,70,3432,37144,24088,20123,7290,3289,1035,96471,11.7,55035,39690,389,380,1121,96615,96603,12,96615,30.81,8.23
2017,4,Chubut,67,4313,83676,5355,7,5,9,0,93432,5.41,56378,15097,1187,14070,6708,93440,91012,2428,93440,51.46,15.78
2017,4,Córdoba,291,25411,280837,102892,217602,40898,24251,8429,700611,11.64,349710,324709,12778,12043,10739,709979,709874,105,709979,63.33,19.39
2017,4,Corrientes,11,5220,41080,23686,16046,5053,2675,0,93771,10.38,56786,34722,894,1334,35,93771,93760,11,93771,32.52,8.56
2017,4,Entre Ríos,1685,9078,95466,45189,30010,7958,4113,0,193499,9.3,107764,73692,1894,10267,86,193703,193654,49,193703,47.89,14.32
2017,4,Formosa,1110,4061,13220,4867,6996,977,824,0,32055,10.11,23410,6973,19,1603,51,32056,32056,0,32056,21.27,5.41
2017,4,Jujuy,345,5364,26566,7721,3507,44,3,0,43550,6.64,33844,9626,20,28,34,43552,43551,1,43552,22.74,5.82
2017,4,La Pampa,310,8729,66053,1227,792,391,81,3503,81086,3.98,10808,50495,8272,10569,1927,82071,81675,396,82071,71.05,23.41
2017,4,La Rioja,9,1488,40777,4083,5813,22,3,0,52195,5.88,16912,34984,14,253,31,52194,52177,17,52194,51.57,13.73
2017,4,Mendoza,26,1656,177646,438,278,29,81,0,180154,5.71,152896,16114,3015,6206,1920,180151,178661,1490,180151,33.33,9.3
2017,4,Misiones,1053,3900,41723,23131,22262,9091,2735,0,103895,11.32,56271,47470,95,5,54,103895,103895,0,103895,31.14,8.48
2017,4,Neuquén,1396,2372,68036,1325,22781,7528,6300,6105,115843,10.72,46739,54119,1017,12404,2692,116971,114965,2006,116971,61.24,18.23
2017,4,Río Negro,409,5598,81078,485,12502,3447,2440,3719,109678,8.05,68690,30451,1250,4259,5114,109764,108702,1062,109764,49.38,15.19
2017,4,Salta,636,4275,73284,32842,18968,3559,84,0,133648,8.45,80705,50446,127,158,1376,132812,132811,1,132812,39.8,9.64
2017,4,San Juan,22,1062,57525,9,0,2,2,0,58622,5.83,54079,451,812,2246,1036,58624,57965,659,58624,30.3,7.72
2017,4,San Luis,59,101,12822,8,0,1,7,1902,14900,5.73,11104,1119,335,17,2329,14904,14604,300,14904,10.59,3.03
2017,4,Santa Cruz,68,78,29073,655,100,1,3,0,29978,5.21,18614,1668,582,4638,3950,29452,29018,434,29452,28.91,8.6
2017,4,Santa Fe,3109,34132,309998,108939,151329,30736,19602,14119,671964,10.3,341680,293831,10602,10965,15382,672460,672137,323,672460,61.71,19.41
2017,4,Santiago Del Estero,41,3091,43544,18773,3359,32,2,0,68842,6.17,27313,40407,19,1025,80,68844,68842,2,68844,29.13,7.23
2017,4,Tierra Del Fuego,6,310,31334,2,0,0,0,0,31652,5.2,19372,6906,530,1,2045,28854,28346,508,28854,59.89,17.76
2017,4,Tucumán,105,8164,78750,45241,24318,1303,4367,0,162248,9.11,156583,5223,105,102,319,162332,162298,34,162332,39.9,9.88
2017,3,Buenos Aires,6577,51411,1733479,311652,676137,140812,108400,0,3028468,8.43,1288025,1571180,124920,35058,38777,3057960,3046758,11202,3057960,55.63,17.94
2017,3,Capital Federal,283,33924,590689,311411,426300,120675,91917,0,1575199,10.64,583249,941092,33481,2814,9723,1570359,1563289,7070,1570359,121.86,51.24
2017,3,Catamarca,52,3204,15383,5758,2563,50,1,0,27011,5.26,26873,4411,12,1,2181,33478,33467,11,33478,32.49,8.27
2017,3,Chaco,95,3496,40059,23008,20307,3827,2004,0,92796,8.48,54888,37307,456,36,1072,93759,93747,12,93759,29.98,8.01
2017,3,Chubut,436,3989,71843,2336,3,0,0,0,78607,3.48,56359,5645,1217,13503,6820,83544,81067,2477,83544,46.22,14.17
2017,3,Córdoba,327,26154,309161,100113,189302,38131,16741,0,679929,9.12,344580,319360,10579,7137,14988,696644,696536,108,696644,62.31,19.08
2017,3,Corrientes,24,5629,44305,22785,15576,2635,1607,0,92561,7.45,56247,33993,947,1334,27,92548,92536,12,92548,32.17,8.47
2017,3,Entre Ríos,1691,7545,98032,42947,29011,3878,2397,0,185501,6.99,107774,69596,1786,6245,63,185464,185414,50,185464,45.96,13.74
2017,3,Formosa,1063,3716,13752,5187,6056,899,459,0,31132,7.07,22647,6816,428,2202,12,32105,32105,0,32105,21.35,5.43
2017,3,Jujuy,337,5723,26835,7369,2962,41,2,0,43269,4.69,33796,9395,20,23,8,43242,43241,1,43242,22.65,5.79
2017,3,La Pampa,343,8244,64794,855,588,327,51,0,75202,3.44,11378,49679,5153,11536,1944,79690,79280,410,79690,69.14,22.78
2017,3,La Rioja,16,1497,40882,3899,5604,23,3,0,51924,5.01,16638,34984,14,252,25,51913,51896,17,51913,51.47,13.7
2017,3,Mendoza,32,95,158461,115,67,29,19,0,158818,3.51,154036,33788,2772,29,1866,192491,190958,1533,192491,35.7,9.96
2017,3,Misiones,1058,4123,42900,22808,23913,3843,1881,0,100526,8.43,56472,43880,110,5,9,100476,100476,0,100476,30.21,8.23
2017,3,Neuquén,2036,1457,72532,1034,20213,7067,4937,0,109276,8.17,48001,52468,1044,11576,2695,115784,113755,2029,115784,60.83,18.11
2017,3,Río Negro,422,5641,83900,306,10116,2965,1659,0,105009,5.49,69301,30018,1106,3054,4017,107496,106393,1103,107496,48.52,14.92
2017,3,Salta,645,4494,78830,32433,14620,2315,63,0,133400,6.13,80782,50284,127,158,1167,132518,132517,1,132518,39.84,9.65
2017,3,San Juan,31,1077,57582,1,0,2,2,0,58695,3.45,54499,5068,816,1053,1013,62449,61789,660,62449,32.37,8.25
2017,3,San Luis,63,3,12325,7,0,1,7,0,12406,3.5,11407,7576,347,26,2363,21719,21408,311,21719,15.48,4.43
2017,3,Santa Cruz,188,23,29102,542,66,33,1,0,29955,3.61,19220,5487,1544,4552,2887,33690,33222,468,33690,33.29,9.91
2017,3,Santa Fe,3116,34019,320017,104453,125339,24536,12982,0,624462,7.79,322953,290655,6338,4897,37499,662342,662086,256,662342,60.91,19.15
2017,3,Santiago Del Estero,69,3288,40435,18489,3047,30,2,0,65360,5.18,27733,54096,19,911,35,82794,82792,2,82794,35.12,8.72
2017,3,Tierra Del Fuego,9,297,33858,0,0,0,0,0,34164,3.48,21587,7012,622,1,2244,31466,30883,583,31466,65.74,19.49
2017,3,Tucumán,109,8948,83070,45302,20514,1361,655,0,159959,6.39,154130,6431,106,40,305,161012,160979,33,161012,39.7,9.83
2017,2,Buenos Aires,7548,47472,1910156,299009,573298,93059,46178,0,2976720,7.2,1378549,1535037,119132,21555,24358,3078631,3067430,11201,3078631,56.27,18.1
2017,2,Capital Federal,556,35663,726223,304970,378571,80234,37977,0,1564194,8.84,615262,932466,38628,2819,11016,1600191,1592175,8016,1600191,124.06,52.24
2017,2,Catamarca,15,3318,15655,5325,2342,47,1,0,26703,5.1,26401,255,14,1,34,26705,26692,13,26705,25.98,6.61
2017,2,Chaco,191,3733,42590,22349,18044,3157,545,0,90609,7.69,54449,35613,458,52,39,90611,90597,14,90611,29.05,7.76
2017,2,Chubut,403,4186,73760,1880,0,0,0,0,80229,3.45,43994,1067,916,13194,4804,63975,62245,1730,63975,35.55,10.9
2017,2,Córdoba,251,26862,370865,88479,146683,20351,5069,0,658560,7.42,341748,303488,4451,6446,1505,657638,657505,133,657638,58.97,18.06
2017,2,Corrientes,15,5912,46483,21776,13043,2218,647,0,90094,6.79,55262,33192,258,1354,31,90097,90085,12,90097,31.39,8.27
2017,2,Entre Ríos,1680,7944,104422,41800,23524,2604,823,0,182797,6.29,108309,67650,254,6448,71,182732,182675,57,182732,45.39,13.57
2017,2,Formosa,1486,3419,14787,4795,4583,749,139,0,29958,6.18,22493,6410,17,1023,13,29956,29956,0,29956,19.97,5.08
2017,2,Jujuy,311,5877,26915,6974,2538,42,1,0,42658,4.54,33742,8858,22,0,35,42657,42656,1,42657,22.4,5.73
2017,2,La Pampa,356,8633,59045,558,336,244,21,0,69193,3.32,12754,48310,5194,6253,511,73022,72573,449,73022,63.49,20.92
2017,2,La Rioja,9,1554,9304,3599,1796,24,2,0,16288,5.53,16244,0,15,2,28,16289,16271,18,16289,16.2,4.31
2017,2,Mendoza,109,24,177203,92,50,5,22,0,177505,3.51,153331,13030,2581,27,1784,170753,169302,1451,170753,31.76,8.86
2017,2,Misiones,1011,4447,47244,22033,21599,2892,570,0,99796,7.6,56752,42925,103,5,9,99794,99794,0,99794,30.09,8.2
2017,2,Neuquén,1542,1395,81272,849,18051,4774,1703,0,109586,6.7,51794,50283,1133,11545,2678,117433,115321,2112,117433,61.91,18.43
2017,2,Río Negro,973,5606,88085,245,7990,1921,559,0,105379,4.74,67038,29147,961,3213,1260,101619,100621,998,101619,46.02,14.16
2017,2,Salta,594,4719,67576,23185,11333,1068,76,0,108551,5.76,80184,27280,115,158,804,108541,108540,1,108541,32.74,7.93
2017,2,San Juan,15,193,58588,0,0,0,4,0,58800,3.49,48670,451,772,1073,915,51881,51261,620,51881,26.96,6.87
2017,2,San Luis,8,4,14014,0,0,1,2,0,14029,3.5,11432,1120,354,26,375,13307,12992,315,13307,9.51,2.72
2017,2,Santa Cruz,188,24,30913,541,66,33,0,0,31765,3.6,15311,2722,1365,4735,2255,26388,26019,369,26388,26.25,7.81
2017,2,Santa Fe,4967,38721,311830,92854,97563,16794,4275,0,567004,6.84,329813,228102,3234,4958,1173,567280,566918,362,567280,52.27,16.44
2017,2,Santiago Del Estero,26,3539,20384,6432,2802,16,0,0,33199,5.06,28337,3900,19,911,29,33196,33194,2,33196,14.12,3.5
2017,2,Tierra Del Fuego,16,285,35409,0,0,0,0,0,35710,3.48,22636,6905,665,1,2350,32557,31938,619,32557,68.46,20.3
2017,2,Tucumán,96,9236,83342,42536,17788,1371,21,0,154390,6.09,149013,5223,116,14,45,154411,154374,37,154411,38.19,9.46
2017,1,Buenos Aires,6017,83918,2057698,402315,523540,90937,22299,0,3186724,6.68,1559178,1465817,118839,21200,24342,3189376,3178174,11202,3189376,58.57,18.8
2017,1,Capital Federal,510,1409,678922,218487,277195,66536,19881,0,1262940,8.35,428801,918328,38259,2730,10928,1399046,1391030,8016,1399046,108.37,45.69
2017,1,Catamarca,15,3328,15861,4901,2161,49,0,0,26315,4.97,26020,248,14,1,34,26317,26304,13,26317,25.66,6.53
2017,1,Chaco,191,3835,44544,21467,15671,3025,314,0,89047,7.31,54430,34277,252,52,39,89050,89036,14,89050,28.62,7.65
2017,1,Chubut,401,4182,73759,1808,0,0,0,0,80150,3.44,43994,999,916,13194,4793,63896,62166,1730,63896,35.66,10.93
2017,1,Córdoba,50,28732,391556,82011,118643,19035,2071,0,642098,6.8,335673,293479,4871,5782,1394,641199,641066,133,641199,57.65,17.65
2017,1,Corrientes,15,6040,48149,20586,11468,2044,303,0,88605,6.43,54993,31994,236,1354,31,88608,88596,12,88608,30.94,8.15
2017,1,Entre Ríos,1680,8080,108379,39146,20562,2254,317,0,180418,5.95,108509,65095,230,6448,71,180353,180296,57,180353,44.91,13.43
2017,1,Formosa,1535,3538,15473,4446,4058,635,22,0,29707,5.74,22438,6215,16,1023,13,29705,29705,0,29705,19.84,5.05
2017,1,Jujuy,330,6213,27824,6486,2306,44,0,0,43203,4.39,33869,9278,22,0,34,43203,43202,1,43203,22.76,5.82
2017,1,La Pampa,362,9279,57739,331,192,165,11,0,68079,3.22,12754,47195,5194,6253,517,71913,71458,455,71913,62.67,20.65
2017,1,La Rioja,9,1578,9486,3409,1718,22,2,0,16224,5.43,16180,0,15,2,28,16225,16207,18,16225,16.2,4.31
2017,1,Mendoza,106,15,177201,86,50,5,22,0,177485,3.51,153326,13030,2581,27,1769,170733,169282,1451,170733,31.84,8.89
2017,1,Misiones,1010,4665,45950,23847,19356,2627,166,0,97621,7.34,57363,40142,101,5,8,97619,97619,0,97619,29.52,8.04
2017,1,Neuquén,1547,1418,83813,902,15130,4223,458,0,107491,6.03,51771,48109,1124,11665,2670,115339,113227,2112,115339,61.02,18.17
2017,1,Río Negro,986,5647,89622,246,6738,1594,200,0,105033,4.45,67075,28785,954,3213,1261,101288,100288,1000,101288,46.03,14.16
2017,1,Salta,579,4861,70922,21554,9386,267,74,0,107643,5.34,79837,26845,114,158,679,107633,107632,1,107633,32.58,7.89
2017,1,San Juan,8,192,58588,0,0,0,4,0,58792,3.49,48670,451,772,1073,907,51873,51253,620,51873,27.04,6.89
2017,1,San Luis,8,4,14014,0,0,1,2,0,14029,3.5,11432,1120,354,26,375,13307,12992,315,13307,9.55,2.73
2017,1,Santa Cruz,190,23,31078,474,68,30,0,0,31863,3.59,15502,2722,1272,4733,2257,26486,26116,370,26486,26.52,7.89
2017,1,Santa Fe,4966,39463,340418,77152,83008,15775,1831,0,562613,6.28,327458,226094,3210,4948,1172,562882,562520,362,562882,51.97,16.34
2017,1,Santiago Del Estero,26,3772,21659,6218,2786,17,0,0,34478,4.95,29616,3900,19,911,29,34475,34473,2,34475,14.7,3.65
2017,1,Tierra Del Fuego,16,285,35409,0,0,0,0,0,35710,3.48,22636,6905,665,1,2350,32557,31938,619,32557,68.92,20.44
2017,1,Tucumán,96,9682,86470,39155,15951,1383,13,0,152750,5.88,147373,5223,116,14,45,152771,152734,37,152771,37.9,9.39
2016,4,Buenos Aires,6055,86281,2085605,403575,467398,72348,17279,0,3138541,6.35,1563542,1414676,118747,21394,24342,3142701,3131499,11202,3142701,61.24,18.58
2016,4,Capital Federal,517,1477,704324,225723,264582,53506,16756,0,1266885,7.96,434835,914952,38161,2583,10928,1401459,1393443,8016,1401459,120.63,45.78
2016,4,Catamarca,15,3478,16519,4889,2077,54,0,0,27032,4.89,26735,250,14,1,34,27034,27021,13,27034,26.54,6.72
2016,4,Chaco,191,3983,45634,21323,14887,2586,250,0,88854,7.08,54974,33534,248,52,39,88847,88833,14,88847,28.79,7.65
2016,4,Chubut,401,4493,73951,1352,0,0,0,0,80197,3.41,43994,955,916,13107,4793,63765,62035,1730,63765,36.07,10.96
2016,4,Córdoba,50,29380,404645,77966,108368,15458,1606,0,637473,6.47,337368,289344,3368,5686,789,636555,636422,133,636555,57.7,17.57
2016,4,Corrientes,15,6109,48995,20187,10908,1645,234,0,88093,6.24,54981,31497,233,1354,31,88096,88084,12,88096,30.98,8.12
2016,4,Entre Ríos,1680,8253,110296,38491,19509,1801,280,0,180310,5.81,109359,64141,226,6448,71,180245,180188,57,180245,45.21,13.45
2016,4,Formosa,1573,3519,15791,4114,3855,649,17,0,29518,5.63,22400,6061,16,1023,13,29513,29513,0,29513,19.85,5.03
2016,4,Jujuy,303,6225,27778,6143,2134,43,0,0,42626,4.32,33838,8731,22,0,34,42625,42624,1,42625,22.65,5.76
2016,4,La Pampa,368,9789,56694,16,335,132,11,0,67345,3.19,12754,47245,5054,6253,522,71828,71368,460,71828,63.02,20.67
2016,4,La Rioja,9,1646,9635,3334,1675,13,3,0,16315,5.34,16270,0,16,2,28,16316,16298,18,16316,16.46,4.35
2016,4,Mendoza,114,16,177194,79,49,5,20,0,177477,3.51,153320,13030,2579,27,1769,170725,169274,1451,170725,32.11,8.91
2016,4,Misiones,1010,4783,47454,23433,18371,2215,126,0,97392,7.11,57983,39294,100,5,8,97390,97390,0,97390,29.72,8.05
2016,4,Neuquén,1539,1406,84859,792,14153,3073,271,0,106093,5.68,51742,46389,1124,11910,2670,113835,111723,2112,113835,60.87,17.99
2016,4,Río Negro,998,2953,92967,248,6317,1174,122,0,104779,4.37,67057,28474,954,3274,1261,101020,100020,1000,101020,46.39,14.17
2016,4,Salta,577,5027,71636,20787,8611,239,70,0,106947,5.22,79389,26657,110,158,621,106935,106934,1,106935,32.69,7.87
2016,4,San Juan,8,220,58608,0,0,0,4,0,58840,3.49,48670,451,772,1121,907,51921,51301,620,51921,27.29,6.91
2016,4,San Luis,8,4,14014,0,0,1,2,0,14029,3.5,11432,1120,354,26,375,13307,12992,315,13307,9.64,2.74
2016,4,Santa Cruz,189,23,31369,342,80,10,0,0,32013,3.56,15607,2722,1055,4823,2257,26464,26094,370,26464,27.05,7.94
2016,4,Santa Fe,4966,40102,349722,74401,77667,13155,1529,0,561542,6.04,326721,225792,3201,4946,1172,561832,561470,362,561832,52.19,16.35
2016,4,Santiago Del Estero,26,3925,22246,6178,2664,15,0,0,35054,4.87,30192,3900,19,911,29,35051,35049,2,35051,15.07,3.72
2016,4,Tierra Del Fuego,16,285,35409,0,0,0,0,0,35710,3.48,22636,6905,665,1,2350,32557,31938,619,32557,70.31,20.57
2016,4,Tucumán,96,10021,87994,37721,14389,1400,10,0,151631,5.73,146995,4482,116,14,45,151652,151615,37,151652,37.98,9.35
2016,3,Buenos Aires,5856,107945,2148475,393530,399116,52900,13318,0,3121140,5.91,1574216,1355770,113463,18867,24276,3086592,3075387,11205,3086592,60.14,18.3
2016,3,Capital Federal,331,995,759028,208249,240856,38341,13886,0,1261686,7.38,447726,905105,36796,2514,10963,1403104,1395053,8051,1403104,120.77,45.85
2016,3,Catamarca,15,4038,16183,4845,1853,50,0,0,26984,4.73,26689,248,14,1,18,26970,26957,13,26970,26.48,6.72
2016,3,Chaco,190,5227,46821,21193,13746,2022,217,0,89416,6.72,56251,32730,232,2,15,89230,89216,14,89230,28.91,7.71
2016,3,Chubut,466,5190,74375,674,0,0,0,0,80705,3.34,43987,935,916,13364,4750,63952,62222,1730,63952,36.18,11.04
2016,3,Córdoba,48,41329,415075,75988,99225,11691,1322,0,644678,6.07,348481,285480,2540,5695,395,642591,642458,133,642591,58.24,17.79
2016,3,Corrientes,15,7425,49471,19956,10006,1263,210,0,88346,5.96,55934,30813,217,1354,22,88340,88328,12,88340,31.07,8.16
2016,3,Entre Ríos,1768,10657,110844,38665,17737,1307,248,0,181226,5.59,112588,61850,206,6441,64,181149,181092,57,181149,45.44,13.55
2016,3,Formosa,1723,4277,15581,3964,3658,648,10,0,29861,5.42,21800,5905,9,0,2,27716,27716,0,27716,18.64,4.73
2016,3,Jujuy,286,6878,27425,5943,1978,31,0,0,42541,4.22,34250,8236,22,0,30,42538,42537,1,42538,22.61,5.76
2016,3,La Pampa,374,10187,55792,15,224,114,11,0,66717,3.14,12751,45952,4910,6236,515,70364,69903,461,70364,61.73,20.29
2016,3,La Rioja,9,2349,9686,3316,1562,11,2,0,16935,5.08,16891,0,15,2,22,16930,16912,18,16930,17.07,4.53
2016,3,Mendoza,37,10,178186,73,48,5,17,0,178376,3.51,153233,13030,2576,28,1757,170624,169174,1450,170624,32.09,8.93
2016,3,Misiones,1010,6030,48871,23394,17043,1559,91,0,97998,6.74,59776,38130,79,5,7,97997,97997,0,97997,29.91,8.12
2016,3,Neuquén,1531,1527,87404,680,12541,2118,225,0,106026,5.29,51752,44739,1093,12402,2617,112603,110491,2112,112603,60.21,17.86
2016,3,Río Negro,1007,6026,90689,207,5953,790,99,0,104771,4.16,67043,28496,942,3293,1252,101026,100024,1002,101026,46.39,14.22
2016,3,Salta,1107,6922,71214,20229,8099,197,50,0,107818,5.05,80866,26113,90,157,565,107791,107790,1,107791,32.96,7.96
2016,3,San Juan,8,245,58577,0,0,0,2,0,58832,3.49,48670,451,770,1174,903,51968,51348,620,51968,27.32,6.94
2016,3,San Luis,7,4,14077,0,0,1,2,0,14091,3.5,11432,1113,354,23,371,13293,12978,315,13293,9.63,2.75
2016,3,Santa Cruz,189,22,31904,221,52,9,0,0,32397,3.54,15570,2722,817,4978,2170,26257,25886,371,26257,26.84,7.93
2016,3,Santa Fe,3958,49501,360606,72657,69864,10210,1308,0,568104,5.68,334911,223011,3037,4862,1190,567011,566625,386,567011,52.67,16.53
2016,3,Santiago Del Estero,26,5097,22747,6216,2497,9,0,0,36592,4.67,31730,3900,19,3,8,35660,35658,2,35660,15.33,3.79
2016,3,Tierra Del Fuego,16,285,35080,0,0,0,0,0,35381,3.48,22636,6276,665,1,2347,31925,31306,619,31925,68.94,20.31
2016,3,Tucumán,127,12247,87970,36518,13150,1288,4,0,151304,5.54,147259,3850,116,53,41,151319,151282,37,151319,37.9,9.36
2016,2,Buenos Aires,10786,133385,2250898,335296,334723,31494,11933,0,3108515,5.42,1579448,1305949,113070,21163,25661,3045291,3032776,12515,3045291,59.34,18.1
2016,2,Capital Federal,4352,1736,859039,146091,213010,19597,13477,0,1257302,6.58,450644,892209,36669,2390,12672,1394584,1384824,9760,1394584,120.04,45.59
2016,2,Catamarca,15,5736,14742,4567,1496,47,1,0,26604,4.36,26262,245,14,1,34,26556,26543,13,26556,26.07,6.63
2016,2,Chaco,197,8063,45823,20346,12090,1571,201,0,88291,6.3,56112,31825,221,52,41,88251,88235,16,88251,28.59,7.64
2016,2,Chubut,572,5421,73078,775,0,0,0,0,79846,3.34,43977,867,916,13293,4803,63856,62116,1740,63856,36.12,11.07
2016,2,Córdoba,258,57050,437547,71980,82618,8355,1242,0,659050,5.52,348891,277615,1709,5610,1089,634914,634680,234,634914,57.55,17.62
2016,2,Corrientes,41,10018,47916,19200,8851,803,191,0,87020,5.6,55511,29845,203,1354,43,86956,86932,24,86956,30.58,8.05
2016,2,Entre Ríos,4734,16368,115000,36917,15522,849,205,0,189595,5.13,112809,58768,169,6434,193,178373,178194,179,178373,44.74,13.38
2016,2,Formosa,1675,5401,14370,3569,3218,593,10,0,28836,5.1,22101,5658,6,1023,14,28802,28801,1,28802,19.37,4.93
2016,2,Jujuy,2561,8292,25301,5589,1750,3,0,0,43496,3.84,33758,7374,22,0,35,41189,41187,2,41189,21.89,5.6
2016,2,La Pampa,429,10616,63928,15,119,96,11,0,75214,3.15,12754,44654,4708,6225,547,68888,68403,485,68888,60.44,19.91
2016,2,La Rioja,10,3151,9043,3190,1344,3,5,0,16746,4.77,16691,0,15,2,28,16736,16718,18,16736,16.88,4.49
2016,2,Mendoza,437,30,176922,61,44,5,20,0,177519,3.5,153321,13030,2576,29,1868,170824,169274,1550,170824,32.13,8.97
2016,2,Misiones,1973,7899,49586,21385,14820,1073,96,0,96832,6.23,59573,36145,77,5,15,95815,95808,7,95815,29.24,7.96
2016,2,Neuquén,1916,1691,88854,583,10241,1285,208,0,104778,4.87,51742,42370,1088,12466,2849,110515,108224,2291,110515,59.1,17.59
2016,2,Río Negro,1189,6107,92158,194,4877,520,86,0,105131,3.98,67031,28100,939,3300,1334,100704,99631,1073,100704,46.24,14.22
2016,2,Salta,2160,10123,70875,18759,7129,140,49,0,109235,4.75,79438,24719,85,151,539,104932,104929,3,104932,32.08,7.77
2016,2,San Juan,10,273,57589,0,0,0,4,0,57876,3.49,48670,451,770,1214,908,52013,51392,621,52013,27.34,6.96
2016,2,San Luis,12,4,13931,0,0,1,2,0,13950,3.5,11432,1063,354,30,377,13256,12939,317,13256,9.6,2.75
2016,2,Santa Cruz,244,26,31995,142,20,0,0,0,32427,3.5,15453,2722,396,4996,2586,26153,25797,356,26153,26.73,7.96
2016,2,Santa Fe,9486,67325,374960,68505,60469,6509,1277,0,588531,5.14,336244,219088,2981,4744,1417,564474,563867,607,564474,52.44,16.49
2016,2,Santiago Del Estero,704,6705,22208,5943,2108,1,0,0,37669,4.31,32101,3900,19,911,30,36961,36958,3,36961,15.89,3.94
2016,2,Tierra Del Fuego,16,286,38773,0,0,0,0,0,39075,3.48,22636,5707,665,1,2350,31359,30740,619,31359,67.72,20.08
2016,2,Tucumán,231,18515,83945,33891,11310,1032,2,0,148926,5.2,145486,2968,116,58,49,148677,148636,41,148677,37.24,9.22
2016,1,Buenos Aires,7351,97880,2214760,289929,247372,8315,9529,0,2875136,4.99,1583560,1200859,111231,21108,25757,2942515,2929903,12612,2942515,57.34,17.54
2016,1,Capital Federal,2310,43686,869048,178665,192644,6577,10838,0,1303768,6.05,454425,832126,36332,2284,12729,1337896,1328079,9817,1337896,115.16,43.76
2016,1,Catamarca,15,6102,14653,4241,1334,42,1,0,26388,4.2,26096,243,15,1,34,26389,26376,13,26389,25.91,6.61
2016,1,Chaco,194,8755,46304,19388,10587,1238,184,0,86650,5.99,56353,29994,211,52,41,86651,86635,16,86651,28.08,7.52
2016,1,Chubut,94,5095,72396,1066,0,0,0,0,78651,3.38,43967,834,916,13280,4803,63800,62060,1740,63800,36.09,11.12
2016,1,Córdoba,148,59484,414452,65763,66455,4143,1039,0,611484,5.16,350884,252346,674,5636,386,609926,609692,234,609926,55.28,16.97
2016,1,Corrientes,29,10690,47833,18375,7911,526,170,0,85534,5.37,55454,28491,192,1354,45,85536,85510,26,85536,30.08,7.94
2016,1,Entre Ríos,2864,17749,104137,35104,14057,457,165,0,174533,5.08,113101,54948,146,6425,193,174813,174634,179,174813,43.85,13.14
2016,1,Formosa,1738,5731,14163,3229,2906,544,5,0,28316,4.87,21852,5420,5,1023,14,28314,28313,1,28314,19.04,4.86
2016,1,Jujuy,2543,8558,22383,5188,1623,0,0,0,40295,3.77,33481,6751,22,0,35,40289,40287,2,40289,21.41,5.49
2016,1,La Pampa,426,11065,52117,15,78,71,11,0,63783,3.05,12754,41881,4536,6209,549,65929,65442,487,65929,57.84,19.1
2016,1,La Rioja,10,3382,9060,2980,1254,2,3,0,16691,4.62,16645,0,16,2,28,16691,16673,18,16691,16.83,4.5
2016,1,Mendoza,235,21,175376,47,43,5,17,0,175744,3.5,153299,13030,2576,34,1871,170810,169257,1553,170810,32.12,8.99
2016,1,Misiones,959,8502,50061,19195,13363,779,68,0,92927,6.0,59538,33330,70,5,15,92958,92951,7,92958,28.37,7.75
2016,1,Neuquén,1720,1737,86310,479,7893,143,171,0,98453,4.42,51702,36122,1085,12502,2850,104261,101969,2292,104261,55.75,16.66
2016,1,Río Negro,1171,6105,90038,203,4246,77,81,0,101921,3.83,66894,27312,937,3341,1338,99822,98745,1077,99822,45.84,14.15
2016,1,Salta,1119,10765,65646,17748,6643,119,31,0,102071,4.74,78973,22741,73,132,507,102426,102423,3,102426,31.32,7.61
2016,1,San Juan,9,309,56447,0,0,0,2,0,56767,3.49,48670,451,770,1195,908,51994,51373,621,51994,27.33,6.98
2016,1,San Luis,8,4,13645,0,0,1,2,0,13660,3.5,11432,1042,354,27,377,13232,12915,317,13232,9.59,2.75
2016,1,Santa Cruz,168,29,32188,8,0,0,0,0,32393,3.48,15654,2723,396,5088,2426,26287,25931,356,26287,26.87,8.05
2016,1,Santa Fe,6492,71565,353525,64117,51293,3754,1063,0,551809,4.9,338052,204816,3014,4686,1428,551996,551378,618,551996,51.28,16.16
2016,1,Santiago Del Estero,703,7219,22805,5769,1898,0,0,0,38394,4.17,32838,3900,19,911,30,37698,37695,3,37698,16.21,4.03
2016,1,Tierra Del Fuego,16,285,33003,0,0,0,0,0,33304,3.48,22636,4834,665,1,2350,30486,29867,619,30486,65.83,19.65
2016,1,Tucumán,106,20092,84008,31490,10046,871,0,0,146613,5.0,144233,2165,116,74,49,146637,146596,41,146637,36.72,9.13
2015,4,Buenos Aires,7985,100303,2253197,274560,240188,3835,8180,0,2888246,4.88,1586343,1223603,103269,20397,25773,2959385,2946743,12642,2959385,58.29,17.68
2015,4,Capital Federal,2417,46568,916813,172029,198635,3087,10899,0,1350450,5.93,455427,879950,19818,2273,12758,1370226,1360381,9845,1370226,118.13,44.83
2015,4,Catamarca,15,6513,14484,4106,1313,39,1,0,26471,4.12,26180,242,15,1,34,26472,26459,13,26472,26.24,6.64
2015,4,Chaco,194,9593,46771,18608,10092,1136,159,0,86553,5.83,56818,29456,186,52,41,86553,86537,16,86553,28.35,7.54
2015,4,Chubut,625,5774,71881,168,0,0,0,0,78448,3.28,43968,811,916,13521,4803,64019,62279,1740,64019,36.89,11.21
2015,4,Córdoba,148,63746,427471,62989,67151,3336,1088,0,625929,5.07,353530,266062,480,5613,385,626070,625835,235,626070,57.36,17.47
2015,4,Corrientes,29,11248,48104,17877,7569,456,150,0,85433,5.26,55681,28178,177,1354,45,85435,85409,26,85435,30.34,7.95
2015,4,Entre Ríos,2865,18883,104224,33989,13668,399,163,0,174191,5.01,113983,53411,122,6427,194,174137,173957,180,174137,44.11,13.12
2015,4,Formosa,1791,6081,14279,2704,2713,519,4,0,28091,4.66,21734,5314,4,1023,14,28089,28088,1,28089,19.07,4.83
2015,4,Jujuy,2551,8876,21867,5044,1587,0,0,0,39925,3.72,32934,6933,22,0,35,39924,39922,2,39924,21.47,5.46
2015,4,La Pampa,592,12951,48798,16,63,49,10,0,62479,2.94,12755,42705,4327,6205,374,66366,66054,312,66366,58.76,19.27
2015,4,La Rioja,10,3638,9127,2937,1215,2,3,0,16932,4.52,16886,0,16,2,28,16932,16914,18,16932,17.32,4.58
2015,4,Mendoza,241,23,174719,38,41,5,13,0,175080,3.5,153293,13030,2572,38,1874,170807,169251,1556,170807,32.49,9.02
2015,4,Misiones,959,9169,51029,17281,13690,675,52,0,92855,5.9,60252,32533,48,5,15,92853,92846,7,92853,28.69,7.77
2015,4,Neuquén,1727,2061,89678,455,7934,9,175,0,102039,4.36,51680,38902,1048,12934,2852,107416,105122,2294,107416,58.29,17.23
2015,4,Río Negro,3282,4473,89062,201,4024,5,75,0,101122,3.77,66851,27221,915,3407,1328,99722,98655,1067,99722,46.44,14.19
2015,4,Salta,1122,11387,65677,17139,6507,99,5,0,101936,4.67,78744,22446,47,129,554,101920,101917,3,101920,31.59,7.6
2015,4,San Juan,9,386,55761,0,0,0,2,0,56158,3.48,48670,451,770,1230,908,52029,51408,621,52029,27.66,7.01
2015,4,San Luis,8,4,13473,0,0,1,2,0,13488,3.5,11432,1025,354,30,377,13218,12901,317,13218,9.71,2.76
2015,4,Santa Cruz,188,26,32338,3,0,0,0,0,32555,3.48,15614,2723,396,5261,2409,26403,26047,356,26403,27.74,8.14
2015,4,Santa Fe,6659,75770,361264,60985,51258,3079,1189,0,560204,4.81,339843,212911,2885,4596,1437,561672,561045,627,561672,52.61,16.47
2015,4,Santiago Del Estero,703,7836,23074,5669,1856,0,0,0,39138,4.09,33582,4365,19,1139,30,39135,39132,3,39135,17.0,4.2
2015,4,Tierra Del Fuego,16,285,32662,0,0,0,0,0,32963,3.47,22636,4301,665,1,2350,29953,29334,619,29953,66.46,19.44
2015,4,Tucumán,107,21800,83887,29942,9507,837,0,0,146080,4.88,144188,1653,116,88,50,146095,146053,42,146095,37.06,9.12
2015,3,Buenos Aires,8361,107351,2266948,262564,200491,2642,7720,0,2856078,4.7,1585467,1183894,113590,19989,25825,2928765,2916070,12695,2928765,57.69,17.55
2015,3,Capital Federal,2448,49340,942525,159618,175594,2028,10022,0,1341574,5.66,454815,871262,30974,2229,12788,1372068,1362193,9875,1372068,118.29,44.91
2015,3,Catamarca,15,6871,14206,4143,812,43,1,0,26091,3.88,25801,242,15,1,34,26093,26080,13,26093,25.86,6.56
2015,3,Chaco,240,10353,47131,19016,7498,979,157,0,85374,5.47,56282,28809,186,52,41,85370,85354,16,85370,27.96,7.45
2015,3,Chubut,641,5886,71668,167,0,0,0,0,78362,3.28,43964,792,916,13408,4803,63883,62143,1740,63883,36.81,11.23
2015,3,Córdoba,150,68765,429787,61109,59372,2582,1048,0,622813,4.87,351692,264055,1450,5412,389,622998,622761,237,622998,57.08,17.43
2015,3,Corrientes,33,11921,48127,18168,6111,453,146,0,84959,5.06,55792,27604,176,1340,47,84959,84931,28,84959,30.17,7.93
2015,3,Entre Ríos,2863,20385,103990,34788,9924,384,153,0,172487,4.77,113909,51945,122,6261,197,172434,172252,182,172434,43.68,13.03
2015,3,Formosa,1862,6521,14354,2791,1842,379,2,0,27751,4.17,21573,5264,2,899,14,27752,27751,1,27752,18.84,4.78
2015,3,Jujuy,2549,9278,21588,5169,966,0,0,0,39550,3.53,32598,6895,22,0,35,39550,39548,2,39550,21.27,5.42
2015,3,La Pampa,613,13087,47660,9,55,39,10,0,61473,2.91,12755,41886,4078,6195,557,65471,64976,495,65471,57.96,19.06
2015,3,La Rioja,10,3840,9102,2984,832,0,3,0,16771,4.25,16725,0,16,2,28,16771,16753,18,16771,17.15,4.55
2015,3,Mendoza,256,25,173430,45,18,5,13,0,173792,3.5,153299,13030,2572,42,1880,170823,169261,1562,170823,32.49,9.04
2015,3,Misiones,958,9809,51234,17367,11654,559,43,0,91624,5.63,59921,31635,46,5,15,91622,91615,7,91622,28.31,7.69
2015,3,Neuquén,1733,2124,85044,210,6599,2,155,0,95867,4.23,47102,36620,1045,13051,2798,100616,98376,2240,100616,54.6,16.2
2015,3,Río Negro,3372,4457,88691,99,3826,1,62,0,100508,3.74,66806,27130,917,3415,1346,99614,98529,1085,99614,46.39,14.22
2015,3,Salta,1126,12223,65405,17451,4318,61,5,0,100589,4.42,78064,21688,47,129,645,100573,100570,3,100573,31.18,7.53
2015,3,San Juan,9,391,54963,0,0,0,2,0,55365,3.48,48670,451,770,1231,908,52030,51409,621,52030,27.67,7.03
2015,3,San Luis,9,4,13286,0,0,1,2,0,13302,3.5,11432,1025,354,31,377,13219,12902,317,13219,9.71,2.77
2015,3,Santa Cruz,190,25,32266,2,0,0,0,0,32483,3.48,15540,2718,396,5226,2391,26271,25912,359,26271,27.61,8.16
2015,3,Santa Fe,6767,80817,363177,59531,42021,2320,1133,0,555766,4.56,337042,209673,4169,4426,1428,556738,556097,641,556738,52.15,16.36
2015,3,Santiago Del Estero,703,8332,23158,5956,1249,0,0,0,39398,3.91,33886,4365,19,1097,30,39397,39394,3,39397,17.12,4.24
2015,3,Tierra Del Fuego,15,285,36408,2,0,0,0,0,36710,3.48,22636,8085,665,1,2350,33737,33118,619,33737,74.86,22.05
2015,3,Tucumán,107,23687,83654,29998,6232,623,0,0,144301,4.57,142925,1135,116,88,50,144314,144272,42,144314,36.61,9.04
2015,2,Buenos Aires,8714,137189,2299705,243503,159922,2010,6712,0,2857754,4.46,1581770,1141052,115660,19268,26040,2883790,2871079,12711,2883790,56.8,17.33
2015,2,Capital Federal,2493,51799,990112,148569,142976,1482,9258,0,1346690,5.31,453178,858342,19786,2172,12806,1346284,1336391,9893,1346284,116.07,44.08
2015,2,Catamarca,15,7253,14003,3776,593,37,1,0,25678,3.68,25387,242,15,1,34,25679,25666,13,25679,25.45,6.48
2015,2,Chaco,288,11058,47551,17675,6337,788,149,0,83846,5.19,55767,27809,179,52,41,83848,83832,16,83848,27.46,7.34
2015,2,Chubut,656,6032,55791,168,0,0,0,0,62647,3.22,43949,762,916,13055,4803,63485,61745,1740,63485,36.58,11.22
2015,2,Córdoba,156,72695,434717,54993,46415,1956,903,0,611835,4.56,348130,255596,435,5199,386,609746,609510,236,609746,55.87,17.11
2015,2,Corrientes,34,12542,48015,17184,5039,379,126,0,83319,4.85,55238,26553,157,1321,47,83316,83288,28,83316,29.58,7.79
2015,2,Entre Ríos,2864,21986,104043,32293,7867,354,136,0,169543,4.55,113378,49767,119,6031,197,169492,169309,183,169492,42.93,12.84
2015,2,Formosa,1881,6907,14247,2436,1324,257,1,0,27053,3.76,21097,5164,2,737,50,27050,27013,37,27050,18.36,4.67
2015,2,Jujuy,2479,9474,20248,4792,730,0,0,0,37723,3.41,32183,5482,22,0,35,37722,37720,2,37722,20.29,5.19
2015,2,La Pampa,5737,8182,46235,27,24,25,10,0,60240,2.86,12756,40825,3719,6190,562,64052,63552,500,64052,56.71,18.69
2015,2,La Rioja,10,4082,9093,2680,641,0,3,0,16509,4.0,16463,0,16,2,28,16509,16491,18,16509,16.88,4.49
2015,2,Mendoza,268,26,170451,42,16,5,13,0,170821,3.5,153301,13030,2572,38,1882,170823,169259,1564,170823,32.49,9.07
2015,2,Misiones,958,10360,51671,15022,10072,408,33,0,88524,5.33,59179,29283,37,5,15,88519,88512,7,88519,27.35,7.45
2015,2,Neuquén,1755,2348,82727,214,5168,2,110,0,92324,4.06,47078,34183,1044,12781,2799,97885,95644,2241,97885,53.12,15.81
2015,2,Río Negro,3413,4525,87362,97,3240,1,51,0,98689,3.67,66738,26268,916,3457,1348,98727,97640,1087,98727,45.98,14.14
2015,2,Salta,1123,13020,64737,16241,3114,29,5,0,98269,4.22,77214,20297,47,129,580,98267,98264,3,98267,30.46,7.38
2015,2,San Juan,8,410,51568,0,0,0,2,0,51988,3.48,48670,451,770,1189,908,51988,51367,621,51988,27.64,7.04
2015,2,San Luis,9,4,13204,0,0,1,2,0,13220,3.5,11432,1025,354,33,377,13221,12904,317,13221,9.71,2.78
2015,2,Santa Cruz,210,25,25519,2,0,0,0,0,25756,3.47,15343,2707,396,4917,2400,25763,25384,379,25763,27.07,8.06
2015,2,Santa Fe,6827,86016,364441,53205,33894,1856,1014,0,547253,4.3,333117,204685,2877,4320,1389,546388,545739,649,546388,51.18,16.09
2015,2,Santiago Del Estero,703,8779,23456,5553,888,0,0,0,39379,3.73,33873,4365,19,1091,30,39378,39375,3,39378,17.11,4.25
2015,2,Tierra Del Fuego,15,285,36073,2,0,0,0,0,36375,3.48,22636,7927,665,1,2350,33579,32960,619,33579,74.51,22.1
2015,2,Tucumán,107,25178,83462,26966,4502,455,0,0,140670,4.31,139944,479,116,88,50,140677,140635,42,140677,35.69,8.84
2015,1,Buenos Aires,8882,123589,2267852,220070,126958,1561,5700,0,2754612,4.32,1583135,1096836,134177,18754,28940,2861842,2847076,14766,2861842,56.37,17.24
2015,1,Capital Federal,2545,59084,1013510,134151,114569,1195,8401,0,1333455,5.0,454934,841743,19334,1994,14716,1332721,1321139,11582,1332721,114.9,43.66
2015,1,Catamarca,13,7634,13754,3202,517,9,1,0,25130,3.48,25033,241,16,1,41,25332,25312,20,25332,25.11,6.4
2015,1,Chaco,26,12053,47425,15883,5346,489,135,0,81357,4.9,54952,26161,164,27,56,81360,81329,31,81360,26.65,7.14
2015,1,Chubut,651,6176,57333,102,0,0,0,0,64262,3.21,45645,717,906,12540,5465,65273,63327,1946,65273,37.61,11.59
2015,1,Córdoba,157,78427,432802,46574,37443,1615,815,0,597833,4.3,343883,247564,415,4645,450,596957,596663,294,596957,54.7,16.79
2015,1,Corrientes,36,13295,47842,15554,4424,235,98,0,81484,4.63,54649,25372,129,1319,62,81531,81488,43,81531,28.95,7.64
2015,1,Entre Ríos,2867,23951,104168,28113,6926,274,119,0,166418,4.35,112363,47411,108,5943,245,166070,165839,231,166070,42.07,12.61
2015,1,Formosa,1891,7336,14413,2024,878,157,1,0,26700,3.38,21022,4951,1,670,56,26700,26657,43,26700,18.12,4.62
2015,1,Jujuy,2458,9754,19858,3939,603,0,0,0,36612,3.24,31505,5048,22,0,36,36611,36608,3,36611,19.69,5.05
2015,1,La Pampa,6059,8054,45038,26,10,13,10,0,59210,2.83,13143,39571,3215,6164,604,62697,62155,542,62697,55.51,18.33
2015,1,La Rioja,11,4201,9379,2207,533,0,3,0,16334,3.78,16282,0,16,2,33,16333,16310,23,16333,16.7,4.46
2015,1,Mendoza,287,24,169763,38,16,6,11,0,170145,3.5,152433,13030,2542,29,2126,170160,168355,1805,170160,32.37,9.06
2015,1,Misiones,958,11136,51906,12387,8543,194,26,0,85150,4.97,58262,26836,30,5,13,85146,85139,7,85146,26.31,7.19
2015,1,Neuquén,1895,2577,80787,170,4067,2,76,0,89574,3.91,47518,32152,1024,12088,2960,95742,93373,2369,95742,51.95,15.53
2015,1,Río Negro,3371,4913,86173,94,2632,2,42,0,97227,3.59,66274,25217,907,3473,1462,97333,96145,1188,97333,45.33,13.99
2015,1,Salta,1123,14151,64992,13955,2569,15,5,0,96810,4.02,76280,19781,47,129,574,96811,96793,18,96811,30.01,7.29
2015,1,San Juan,8,445,51346,0,0,0,2,0,51801,3.48,48441,451,755,1165,1007,51819,51117,702,51819,27.55,7.04
2015,1,San Luis,10,8,12720,0,1,0,2,0,12741,3.5,11414,1025,351,30,412,13232,12878,354,13232,9.72,2.79
2015,1,Santa Cruz,205,27,26048,2,0,0,0,0,26282,3.47,16215,2700,392,4772,2562,26641,26217,424,26641,27.99,8.39
2015,1,Santa Fe,6883,93096,360964,45270,27597,1542,900,0,536252,4.06,328809,199037,2845,4239,1507,536437,535640,797,536437,50.24,15.83
2015,1,Santiago Del Estero,701,9236,23136,4796,748,0,0,0,38617,3.57,33813,4365,19,1020,35,39252,39244,8,39252,17.06,4.24
2015,1,Tierra Del Fuego,14,609,36319,2,0,0,0,0,36944,3.45,22291,7924,657,1,2583,33456,32726,730,33456,74.23,22.17
2015,1,Tucumán,107,27143,83895,23061,3722,334,0,0,138262,4.07,137857,115,116,88,100,138276,138184,92,138276,35.08,8.72
2014,4,Buenos Aires,8226,132937,2250445,203620,104322,997,5406,0,2705954,4.2,1575978,1070135,120528,17728,32038,2816407,2801178,15229,2816407,56.09,17.01
2014,4,Capital Federal,2698,62896,1038269,123451,95772,890,7997,0,1331972,4.78,455785,840224,17155,1962,15394,1330520,1318526,11994,1330520,114.9,43.6
2014,4,Catamarca,21,8047,14093,2910,421,0,1,0,25493,3.34,25192,241,16,0,44,25493,25472,21,25493,25.51,6.46
2014,4,Chaco,483,12837,42106,7908,2600,124,2,0,66060,3.98,55024,10918,31,0,62,66035,65998,37,66035,21.87,5.81
2014,4,Chubut,1858,6218,60392,70,0,0,0,0,68538,3.17,48539,697,891,12256,6159,68542,66557,1985,68542,40.25,12.22
2014,4,Córdoba,1903,85362,427844,41947,30858,1177,782,0,589873,4.09,345157,240452,419,3918,486,590432,590113,319,590432,54.7,16.66
2014,4,Corrientes,40,13860,42182,7513,2106,0,9,0,65710,3.81,54754,9526,40,1315,75,65710,65656,54,65710,23.56,6.17
2014,4,Entre Ríos,2311,27801,88649,18318,3584,1,66,0,140730,3.8,112291,23027,57,5178,260,140813,140567,246,140813,36.03,10.72
2014,4,Formosa,1947,7830,14058,1852,473,47,1,0,26208,3.02,21245,4896,1,0,65,26207,26156,51,26207,17.96,4.55
2014,4,Jujuy,1880,10427,19740,3443,465,0,0,0,35955,3.13,31349,4583,22,37,11,36002,35999,3,36002,19.6,4.98
2014,4,La Pampa,6266,6879,36520,26,5,4,10,0,49710,2.75,16043,34281,514,5894,648,57380,56813,567,57380,51.27,16.82
2014,4,La Rioja,9,4333,9728,1943,386,0,3,0,16402,3.58,16352,0,17,0,33,16402,16379,23,16402,17.01,4.5
2014,4,Mendoza,303,19,169222,36,14,5,12,0,169611,3.5,151797,13030,2534,31,2222,169614,167766,1848,169614,32.64,9.06
2014,4,Misiones,547,11840,53093,8731,2952,54,12,0,77229,4.03,58435,18613,16,150,15,77229,77222,7,77229,24.16,6.54
2014,4,Neuquén,1731,2744,80938,126,3621,2,66,0,89228,3.85,47721,31778,1014,11853,3030,95396,92999,2397,95396,52.55,15.53
2014,4,Río Negro,3640,4723,85094,94,2319,4,30,0,95904,3.54,66307,23703,901,3819,1530,96260,95050,1210,96260,45.48,13.89
2014,4,Salta,54,16214,63221,12552,1922,0,4,0,93967,3.86,76026,17289,48,6,578,93947,93921,26,93947,29.53,7.1
2014,4,San Juan,11,478,51628,0,0,0,2,0,52119,3.48,48653,451,740,1202,1073,52119,51390,729,52119,28.04,7.1
2014,4,San Luis,9,0,13135,0,0,1,2,0,13147,3.5,11419,926,355,24,423,13147,12788,359,13147,9.79,2.78
2014,4,Santa Cruz,156,1400,24145,1,1,0,0,0,25703,3.33,17553,448,388,4395,2929,25713,25277,436,25713,27.8,8.16
2014,4,Santa Fe,8707,99962,359293,36718,21098,869,824,0,527471,3.78,335267,183009,3205,6282,1634,529397,528459,938,529397,50.0,15.66
2014,4,Santiago Del Estero,1246,8913,24181,4359,602,0,0,0,39301,3.46,34110,4231,19,920,37,39317,39308,9,39317,17.27,4.26
2014,4,Tierra Del Fuego,12,283,31489,2,0,0,0,0,31786,3.47,21948,3664,655,1,2722,28990,28249,741,28990,66.14,19.34
2014,4,Tucumán,17,28746,85091,20631,2733,196,0,0,137414,3.86,137093,97,116,13,105,137424,137329,95,137424,35.32,8.69
2014,3,Buenos Aires,7355,128187,2281524,156693,68947,243,4232,0,2647181,3.97,1562533,1110628,124474,20049,31881,2849565,2835537,14028,2849565,56.75,17.26
2014,3,Capital Federal,840,78016,1060145,102170,70907,95,6626,0,1318799,4.44,450155,833402,17886,1995,14387,1317825,1307195,10630,1317825,113.8,43.21
2014,3,Catamarca,19,8845,13790,1915,111,0,0,0,24680,2.92,24380,244,15,0,47,24686,24665,21,24686,24.71,6.27
2014,3,Chaco,398,14731,41934,5428,1274,5,0,0,63770,3.46,53321,10336,29,1,59,63746,63710,36,63746,21.11,5.63
2014,3,Chubut,2013,6281,60771,34,0,0,0,0,69099,3.17,49219,668,882,11853,6515,69137,67130,2007,69137,40.6,12.39
2014,3,Córdoba,660,98992,435692,28992,18888,84,664,0,583972,3.66,340212,240334,444,4064,377,585431,585231,200,585431,54.23,16.56
2014,3,Corrientes,21,15448,41717,5181,1172,0,0,0,63539,3.41,52957,9184,31,1312,65,63549,63516,33,63549,22.79,5.99
2014,3,Entre Ríos,1709,29710,91450,12569,1310,0,48,0,136796,3.4,108907,22440,48,5203,135,136733,136618,115,136733,34.98,10.43
2014,3,Formosa,2001,8323,14202,1324,85,0,0,0,25935,2.66,21021,4836,0,0,80,25937,25873,64,25937,17.77,4.51
2014,3,Jujuy,127,10979,20216,2305,82,0,0,0,33709,2.93,30128,3541,22,37,13,33741,33739,2,33741,18.37,4.68
2014,3,La Pampa,6458,6645,41009,24,5,4,10,0,54155,2.82,16051,33940,538,11219,677,62425,61861,564,62425,55.78,18.34
2014,3,La Rioja,10,4785,9720,1337,61,0,0,0,15913,3.1,15864,0,14,1,37,15916,15893,23,15916,16.51,4.38
2014,3,Mendoza,35,0,167763,31,12,13,1,0,167855,3.5,150120,13030,2512,40,2222,167924,166184,1740,167924,32.31,8.99
2014,3,Misiones,640,13637,53510,5928,1606,0,1,0,75322,3.58,56933,18373,4,3,14,75327,75327,0,75327,23.57,6.4
2014,3,Neuquén,1522,3099,80090,107,2865,10,27,0,87720,3.74,54458,30964,1000,12858,3087,102367,100099,2268,102367,56.4,16.73
2014,3,Río Negro,3640,5189,86868,87,1944,8,9,0,97745,3.48,65264,26590,888,3533,1505,97780,96629,1151,97780,46.2,14.16
2014,3,Salta,732,17481,66026,8314,388,0,0,0,92941,3.41,73828,18394,43,109,580,92954,92929,25,92954,29.22,7.05
2014,3,San Juan,8,487,51276,0,0,0,0,0,51771,3.47,48272,451,731,1199,1126,51779,51031,748,51779,27.85,7.08
2014,3,San Luis,8,0,13029,0,0,3,0,0,13040,3.5,11303,925,355,25,438,13046,12683,363,13046,9.71,2.77
2014,3,Santa Cruz,195,1624,24248,1,1,0,0,0,26069,3.31,17862,492,385,4273,3098,26110,25664,446,26110,28.23,8.34
2014,3,Santa Fe,8230,112593,357615,23962,12124,38,806,0,515368,3.38,325577,183630,4407,6540,733,520887,520196,691,520887,49.2,15.44
2014,3,Santiago Del Estero,791,9914,23826,2867,142,0,0,0,37540,3.1,32820,3900,19,768,41,37548,37539,9,37548,16.49,4.08
2014,3,Tierra Del Fuego,12,336,32348,2,0,0,0,0,32698,3.47,21840,3469,650,1,2832,28792,28037,755,28792,65.69,19.34
2014,3,Tucumán,6,32716,84668,14101,559,4,0,0,132054,3.35,131739,97,117,13,100,132066,131978,88,132066,33.94,8.38
2014,2,Buenos Aires,6902,162274,2288772,140226,56549,284,4309,0,2659316,3.85,1568881,1025490,120008,17020,33147,2764546,2750430,14116,2764546,55.06,16.79
2014,2,Capital Federal,847,81431,1078213,87359,56004,59,6427,0,1310340,4.25,447637,828411,17729,1883,14555,1310215,1299502,10713,1310215,113.14,42.97
2014,2,Catamarca,19,8844,13794,1915,111,0,0,0,24683,2.92,24380,243,17,0,43,24683,24660,23,24683,24.7,6.28
2014,2,Chaco,412,14854,41530,5418,1085,5,0,0,63304,3.42,53321,9870,30,0,58,63279,63243,36,63279,20.96,5.6
2014,2,Chubut,2064,6582,61868,0,0,0,0,0,70514,3.16,51070,649,866,10960,6974,70519,68503,2016,70519,41.41,12.7
2014,2,Córdoba,2105,101598,429536,28698,14824,76,627,0,577464,3.56,337825,234729,351,3673,374,576952,576747,205,576952,53.45,16.37
2014,2,Corrientes,20,15563,41219,5199,956,0,0,0,62957,3.37,52883,8680,31,1309,55,62958,62925,33,62958,22.58,5.95
2014,2,Entre Ríos,2187,32781,86757,12564,1162,0,44,0,135495,3.31,108900,21706,49,4795,133,135583,135468,115,135583,34.69,10.37
2014,2,Formosa,2032,8218,13944,1321,85,0,0,0,25600,2.65,20894,4628,0,0,78,25600,25535,65,25600,17.54,4.46
2014,2,Jujuy,1873,11233,18851,2305,82,0,0,0,34344,2.77,30128,4161,23,40,9,34361,34359,2,34361,18.71,4.78
2014,2,La Pampa,7032,6761,34089,18,5,4,10,0,47919,2.68,15957,32600,513,5869,689,55628,55048,580,55628,49.71,16.38
2014,2,La Rioja,10,4785,9719,1337,61,0,0,0,15912,3.1,15864,0,14,0,34,15912,15889,23,15912,16.5,4.39
2014,2,Mendoza,35,6,166710,31,10,5,10,0,166807,3.5,148979,13030,2480,36,2282,166807,165046,1761,166807,32.1,8.96
2014,2,Misiones,540,13644,53245,5924,1334,2,0,0,74689,3.54,56933,17594,4,150,8,74689,74689,0,74689,23.37,6.37
2014,2,Neuquén,1531,3206,79087,92,2289,2,30,0,86237,3.66,47767,29776,997,10765,2983,92288,90053,2235,92288,50.84,15.14
2014,2,Río Negro,3468,5507,84978,78,1569,2,8,0,95610,3.43,64920,24944,876,3657,1560,95957,94812,1145,95957,45.33,13.95
2014,2,Salta,53,18818,64440,8293,388,0,0,0,91992,3.39,73841,17504,45,7,577,91974,91949,25,91974,28.91,7.0
2014,2,San Juan,10,507,51129,0,0,0,0,0,51646,3.47,48161,451,722,1139,1173,51646,50891,755,51646,27.78,7.08
2014,2,San Luis,7,0,13045,0,0,1,2,0,13055,3.5,11306,925,354,22,448,13055,12691,364,13055,9.72,2.78
2014,2,Santa Cruz,153,1637,25374,2,0,0,0,0,27166,3.32,18956,448,381,4118,3266,27169,26710,459,27169,29.38,8.74
2014,2,Santa Fe,8515,115197,353559,23939,10058,34,792,0,512094,3.31,324101,178495,3085,6041,636,512358,511753,605,512358,48.39,15.22
2014,2,Santiago Del Estero,1231,9914,23842,2867,142,0,0,0,37996,3.07,32820,4231,19,907,34,38011,38002,9,38011,16.7,4.14
2014,2,Tierra Del Fuego,12,334,31198,2,0,0,0,0,31546,3.47,21618,3008,648,1,2934,28209,27443,766,28209,64.36,19.09
2014,2,Tucumán,6,32714,84675,14101,559,4,0,0,132059,3.35,131740,97,121,13,98,132069,131981,88,132069,33.94,8.41
2014,1,Buenos Aires,8469,171244,2279875,121787,38923,206,4037,0,2624542,3.73,1567685,1000879,120960,16528,33824,2739876,2725732,14144,2739876,54.57,16.69
2014,1,Capital Federal,852,88826,1096050,70293,38798,55,6208,0,1301081,4.02,445569,820161,17767,1866,14555,1299918,1289204,10714,1299918,112.25,42.66
2014,1,Catamarca,19,9147,13330,1672,64,0,0,0,24232,2.8,24126,46,17,0,43,24232,24209,23,24232,24.25,6.18
2014,1,Chaco,438,15849,40869,4644,741,5,0,0,62546,3.26,52971,9497,30,0,58,62556,62520,36,62556,20.72,5.55
2014,1,Chubut,7452,10,61329,0,0,0,0,0,68791,3.18,51066,539,866,10776,6974,70221,68205,2016,70221,41.24,12.7
2014,1,Córdoba,2076,107705,423114,24112,9818,40,588,0,567453,3.39,336841,225769,347,3585,368,566910,566705,205,566910,52.52,16.13
2014,1,Corrientes,20,16357,40742,4486,630,0,0,0,62235,3.22,52565,8279,31,1306,55,62236,62203,33,62236,22.32,5.89
2014,1,Entre Ríos,2177,35206,85248,10828,746,0,43,0,134248,3.17,107883,21379,49,4887,133,134331,134216,115,134331,34.37,10.3
2014,1,Formosa,2062,8475,13685,1133,67,0,0,0,25422,2.57,20774,4548,0,0,100,25422,25335,87,25422,17.42,4.44
2014,1,Jujuy,1832,11498,18415,2002,56,0,0,0,33803,2.69,29765,4030,23,0,9,33827,33825,2,33827,18.42,4.72
2014,1,La Pampa,7434,6535,32501,17,5,4,10,0,46506,2.65,15826,31305,513,5848,701,54193,53601,592,54193,48.43,15.99
2014,1,La Rioja,10,5111,9390,1165,35,0,0,0,15711,2.96,15663,0,14,0,34,15711,15688,23,15711,16.29,4.35
2014,1,Mendoza,35,6,166655,19,10,6,9,0,166740,3.5,148970,12076,2480,37,2282,165845,164084,1761,165845,31.91,8.93
2014,1,Misiones,545,14460,52852,5139,958,0,0,0,73954,3.4,56597,17191,4,150,8,73950,73950,0,73950,23.14,6.32
2014,1,Neuquén,4133,987,77148,84,1582,2,22,0,83958,3.55,47790,28161,997,10381,3051,90380,88077,2303,90380,49.79,14.88
2014,1,Río Negro,4670,4618,84304,73,1062,1,8,0,94736,3.35,64886,24156,876,3576,1572,95066,93909,1157,95066,44.91,13.87
2014,1,Salta,53,19677,64061,7192,314,0,0,0,91297,3.3,73131,17538,45,8,568,91290,91265,25,91290,28.7,6.98
2014,1,San Juan,531,2,51056,0,0,0,0,0,51589,3.47,48161,434,722,808,1173,51298,50543,755,51298,27.6,7.05
2014,1,San Luis,7,3,12544,0,1,0,2,0,12557,3.5,11306,428,354,21,448,12557,12193,364,12557,9.35,2.68
2014,1,Santa Cruz,161,1625,24972,1,1,0,0,0,26760,3.32,18927,100,381,4092,3264,26764,26304,460,26764,28.94,8.68
2014,1,Santa Fe,8456,124468,345225,20328,6845,23,668,0,506013,3.15,322662,174296,3059,5951,644,506612,506000,612,506612,47.85,15.08
2014,1,Santiago Del Estero,1234,10531,22817,2422,109,0,0,0,37113,2.95,32567,3598,19,915,34,37133,37124,9,37133,16.31,4.06
2014,1,Tierra Del Fuego,12,607,30902,6,0,0,0,0,31527,3.45,21618,2837,648,1,2934,28038,27272,766,28038,63.97,19.1
2014,1,Tucumán,6,34672,83210,11779,362,3,0,0,130032,3.21,129717,83,121,13,98,130032,129944,88,130032,33.42,8.31
